"filename", "language", "JSON", "JSON with Comments", "TypeScript", "Markdown", "YAML", "comment", "blank", "total"
"c:\Users\Usuario\Desktop\Practica Angular\14-Clean-Architecture-Node-Express-Mongo\docker-compose.yml", "YAML", 0, 0, 0, 0, 12, 0, 3, 15
"c:\Users\Usuario\Desktop\Practica Angular\14-Clean-Architecture-Node-Express-Mongo\package-lock.json", "JSON", 2624, 0, 0, 0, 0, 0, 1, 2625
"c:\Users\Usuario\Desktop\Practica Angular\14-Clean-Architecture-Node-Express-Mongo\package.json", "JSON", 33, 0, 0, 0, 0, 0, 1, 34
"c:\Users\Usuario\Desktop\Practica Angular\14-Clean-Architecture-Node-Express-Mongo\readme.md", "Markdown", 0, 0, 0, 42, 0, 0, 21, 63
"c:\Users\Usuario\Desktop\Practica Angular\14-Clean-Architecture-Node-Express-Mongo\src\app.ts", "TypeScript", 0, 0, 16, 0, 0, 3, 4, 23
"c:\Users\Usuario\Desktop\Practica Angular\14-Clean-Architecture-Node-Express-Mongo\src\configs\bcrypt.ts", "TypeScript", 0, 0, 9, 0, 0, 0, 4, 13
"c:\Users\Usuario\Desktop\Practica Angular\14-Clean-Architecture-Node-Express-Mongo\src\configs\envs.ts", "TypeScript", 0, 0, 8, 0, 0, 0, 6, 14
"c:\Users\Usuario\Desktop\Practica Angular\14-Clean-Architecture-Node-Express-Mongo\src\configs\jwt-personal.ts", "TypeScript", 0, 0, 26, 0, 0, 7, 8, 41
"c:\Users\Usuario\Desktop\Practica Angular\14-Clean-Architecture-Node-Express-Mongo\src\configs\jwt.ts", "TypeScript", 0, 0, 21, 0, 0, 4, 12, 37
"c:\Users\Usuario\Desktop\Practica Angular\14-Clean-Architecture-Node-Express-Mongo\src\configs\validator.ts", "TypeScript", 0, 0, 5, 0, 0, 1, 4, 10
"c:\Users\Usuario\Desktop\Practica Angular\14-Clean-Architecture-Node-Express-Mongo\src\data\mongodb\models\customers\city.model.ts", "TypeScript", 0, 0, 24, 0, 0, 0, 2, 26
"c:\Users\Usuario\Desktop\Practica Angular\14-Clean-Architecture-Node-Express-Mongo\src\data\mongodb\models\customers\customer.model.ts", "TypeScript", 0, 0, 41, 0, 0, 0, 2, 43
"c:\Users\Usuario\Desktop\Practica Angular\14-Clean-Architecture-Node-Express-Mongo\src\data\mongodb\models\customers\neighborhood.model.ts", "TypeScript", 0, 0, 29, 0, 0, 1, 3, 33
"c:\Users\Usuario\Desktop\Practica Angular\14-Clean-Architecture-Node-Express-Mongo\src\data\mongodb\models\products\category.model.ts", "TypeScript", 0, 0, 20, 0, 0, 0, 6, 26
"c:\Users\Usuario\Desktop\Practica Angular\14-Clean-Architecture-Node-Express-Mongo\src\data\mongodb\models\products\product.model.ts", "TypeScript", 0, 0, 47, 0, 0, 0, 5, 52
"c:\Users\Usuario\Desktop\Practica Angular\14-Clean-Architecture-Node-Express-Mongo\src\data\mongodb\models\products\unit.model.ts", "TypeScript", 0, 0, 21, 0, 0, 0, 3, 24
"c:\Users\Usuario\Desktop\Practica Angular\14-Clean-Architecture-Node-Express-Mongo\src\data\mongodb\models\user.model.ts", "TypeScript", 0, 0, 34, 0, 0, 3, 7, 44
"c:\Users\Usuario\Desktop\Practica Angular\14-Clean-Architecture-Node-Express-Mongo\src\data\mongodb\mongo-database.ts", "TypeScript", 0, 0, 20, 0, 0, 0, 9, 29
"c:\Users\Usuario\Desktop\Practica Angular\14-Clean-Architecture-Node-Express-Mongo\src\domain\datasources\auth.datasource.ts", "TypeScript", 0, 0, 7, 0, 0, 2, 4, 13
"c:\Users\Usuario\Desktop\Practica Angular\14-Clean-Architecture-Node-Express-Mongo\src\domain\datasources\customers\city.datasource.ts", "TypeScript", 0, 0, 13, 0, 0, 0, 1, 14
"c:\Users\Usuario\Desktop\Practica Angular\14-Clean-Architecture-Node-Express-Mongo\src\domain\datasources\customers\customer.datasource.ts", "TypeScript", 0, 0, 13, 0, 0, 0, 1, 14
"c:\Users\Usuario\Desktop\Practica Angular\14-Clean-Architecture-Node-Express-Mongo\src\domain\datasources\customers\neighborhood.datasource.ts", "TypeScript", 0, 0, 14, 0, 0, 0, 1, 15
"c:\Users\Usuario\Desktop\Practica Angular\14-Clean-Architecture-Node-Express-Mongo\src\domain\datasources\products\category.datasource.ts", "TypeScript", 0, 0, 13, 0, 0, 0, 6, 19
"c:\Users\Usuario\Desktop\Practica Angular\14-Clean-Architecture-Node-Express-Mongo\src\domain\datasources\products\product.datasource.ts", "TypeScript", 0, 0, 15, 0, 0, 1, 8, 24
"c:\Users\Usuario\Desktop\Practica Angular\14-Clean-Architecture-Node-Express-Mongo\src\domain\datasources\products\unit.datasource.ts", "TypeScript", 0, 0, 13, 0, 0, 0, 4, 17
"c:\Users\Usuario\Desktop\Practica Angular\14-Clean-Architecture-Node-Express-Mongo\src\domain\dtos\auth\login-user.dto.ts", "TypeScript", 0, 0, 14, 0, 0, 1, 10, 25
"c:\Users\Usuario\Desktop\Practica Angular\14-Clean-Architecture-Node-Express-Mongo\src\domain\dtos\auth\register-user.dto.ts", "TypeScript", 0, 0, 17, 0, 0, 12, 13, 42
"c:\Users\Usuario\Desktop\Practica Angular\14-Clean-Architecture-Node-Express-Mongo\src\domain\dtos\customers\create-city.dto.ts", "TypeScript", 0, 0, 24, 0, 0, 4, 5, 33
"c:\Users\Usuario\Desktop\Practica Angular\14-Clean-Architecture-Node-Express-Mongo\src\domain\dtos\customers\create-customer.dto.ts", "TypeScript", 0, 0, 42, 0, 0, 6, 9, 57
"c:\Users\Usuario\Desktop\Practica Angular\14-Clean-Architecture-Node-Express-Mongo\src\domain\dtos\customers\create-neighborhood.dto.ts", "TypeScript", 0, 0, 30, 0, 0, 5, 7, 42
"c:\Users\Usuario\Desktop\Practica Angular\14-Clean-Architecture-Node-Express-Mongo\src\domain\dtos\customers\update-city.dto.ts", "TypeScript", 0, 0, 37, 0, 0, 3, 6, 46
"c:\Users\Usuario\Desktop\Practica Angular\14-Clean-Architecture-Node-Express-Mongo\src\domain\dtos\customers\update-customer.dto.ts", "TypeScript", 0, 0, 65, 0, 0, 3, 10, 78
"c:\Users\Usuario\Desktop\Practica Angular\14-Clean-Architecture-Node-Express-Mongo\src\domain\dtos\customers\update-neighborhood.dto.ts", "TypeScript", 0, 0, 45, 0, 0, 3, 7, 55
"c:\Users\Usuario\Desktop\Practica Angular\14-Clean-Architecture-Node-Express-Mongo\src\domain\dtos\products\create-category.ts", "TypeScript", 0, 0, 14, 0, 0, 5, 10, 29
"c:\Users\Usuario\Desktop\Practica Angular\14-Clean-Architecture-Node-Express-Mongo\src\domain\dtos\products\create-product.dto.ts", "TypeScript", 0, 0, 24, 0, 0, 5, 13, 42
"c:\Users\Usuario\Desktop\Practica Angular\14-Clean-Architecture-Node-Express-Mongo\src\domain\dtos\products\create-unit.dto.ts", "TypeScript", 0, 0, 14, 0, 0, 5, 8, 27
"c:\Users\Usuario\Desktop\Practica Angular\14-Clean-Architecture-Node-Express-Mongo\src\domain\dtos\products\udpate-unit.dto.ts", "TypeScript", 0, 0, 34, 0, 0, 7, 10, 51
"c:\Users\Usuario\Desktop\Practica Angular\14-Clean-Architecture-Node-Express-Mongo\src\domain\dtos\products\update-category.dto.ts", "TypeScript", 0, 0, 28, 0, 0, 4, 9, 41
"c:\Users\Usuario\Desktop\Practica Angular\14-Clean-Architecture-Node-Express-Mongo\src\domain\dtos\products\update-product.dto.ts", "TypeScript", 0, 0, 33, 0, 0, 3, 10, 46
"c:\Users\Usuario\Desktop\Practica Angular\14-Clean-Architecture-Node-Express-Mongo\src\domain\dtos\shared\pagination.dto.ts", "TypeScript", 0, 0, 14, 0, 0, 5, 8, 27
"c:\Users\Usuario\Desktop\Practica Angular\14-Clean-Architecture-Node-Express-Mongo\src\domain\entities\customers\citiy.ts", "TypeScript", 0, 0, 8, 0, 0, 0, 2, 10
"c:\Users\Usuario\Desktop\Practica Angular\14-Clean-Architecture-Node-Express-Mongo\src\domain\entities\customers\customer.ts", "TypeScript", 0, 0, 12, 0, 0, 0, 2, 14
"c:\Users\Usuario\Desktop\Practica Angular\14-Clean-Architecture-Node-Express-Mongo\src\domain\entities\customers\neighborhood.ts", "TypeScript", 0, 0, 10, 0, 0, 0, 3, 13
"c:\Users\Usuario\Desktop\Practica Angular\14-Clean-Architecture-Node-Express-Mongo\src\domain\entities\products\category.entity.ts", "TypeScript", 0, 0, 8, 0, 0, 0, 1, 9
"c:\Users\Usuario\Desktop\Practica Angular\14-Clean-Architecture-Node-Express-Mongo\src\domain\entities\products\product.entity.ts", "TypeScript", 0, 0, 15, 0, 0, 0, 2, 17
"c:\Users\Usuario\Desktop\Practica Angular\14-Clean-Architecture-Node-Express-Mongo\src\domain\entities\products\unit.entity.ts", "TypeScript", 0, 0, 8, 0, 0, 0, 2, 10
"c:\Users\Usuario\Desktop\Practica Angular\14-Clean-Architecture-Node-Express-Mongo\src\domain\entities\user.entity.ts", "TypeScript", 0, 0, 10, 0, 0, 3, 4, 17
"c:\Users\Usuario\Desktop\Practica Angular\14-Clean-Architecture-Node-Express-Mongo\src\domain\errors\custom.error.ts", "TypeScript", 0, 0, 27, 0, 0, 0, 8, 35
"c:\Users\Usuario\Desktop\Practica Angular\14-Clean-Architecture-Node-Express-Mongo\src\domain\repositories\auth.repository.ts", "TypeScript", 0, 0, 7, 0, 0, 2, 4, 13
"c:\Users\Usuario\Desktop\Practica Angular\14-Clean-Architecture-Node-Express-Mongo\src\domain\repositories\customers\city.repository.ts", "TypeScript", 0, 0, 13, 0, 0, 0, 1, 14
"c:\Users\Usuario\Desktop\Practica Angular\14-Clean-Architecture-Node-Express-Mongo\src\domain\repositories\customers\customer.repository.ts", "TypeScript", 0, 0, 13, 0, 0, 0, 1, 14
"c:\Users\Usuario\Desktop\Practica Angular\14-Clean-Architecture-Node-Express-Mongo\src\domain\repositories\customers\neighborhood.repository.ts", "TypeScript", 0, 0, 14, 0, 0, 0, 1, 15
"c:\Users\Usuario\Desktop\Practica Angular\14-Clean-Architecture-Node-Express-Mongo\src\domain\repositories\products\categroy.repository.ts", "TypeScript", 0, 0, 13, 0, 0, 0, 4, 17
"c:\Users\Usuario\Desktop\Practica Angular\14-Clean-Architecture-Node-Express-Mongo\src\domain\repositories\products\product.repository.ts", "TypeScript", 0, 0, 15, 0, 0, 1, 6, 22
"c:\Users\Usuario\Desktop\Practica Angular\14-Clean-Architecture-Node-Express-Mongo\src\domain\repositories\products\unit.repository.ts", "TypeScript", 0, 0, 13, 0, 0, 0, 2, 15
"c:\Users\Usuario\Desktop\Practica Angular\14-Clean-Architecture-Node-Express-Mongo\src\domain\use-cases\auth\login-user.use-case.ts", "TypeScript", 0, 0, 47, 0, 0, 10, 25, 82
"c:\Users\Usuario\Desktop\Practica Angular\14-Clean-Architecture-Node-Express-Mongo\src\domain\use-cases\auth\register-user.use-case.ts", "TypeScript", 0, 0, 46, 0, 0, 10, 23, 79
"c:\Users\Usuario\Desktop\Practica Angular\14-Clean-Architecture-Node-Express-Mongo\src\domain\use-cases\customers\create-city.use-case.ts", "TypeScript", 0, 0, 33, 0, 0, 4, 8, 45
"c:\Users\Usuario\Desktop\Practica Angular\14-Clean-Architecture-Node-Express-Mongo\src\domain\use-cases\customers\create-customer.use-case.ts", "TypeScript", 0, 0, 32, 0, 0, 4, 6, 42
"c:\Users\Usuario\Desktop\Practica Angular\14-Clean-Architecture-Node-Express-Mongo\src\domain\use-cases\customers\create-neighborhood.use-case.ts", "TypeScript", 0, 0, 39, 0, 0, 4, 8, 51
"c:\Users\Usuario\Desktop\Practica Angular\14-Clean-Architecture-Node-Express-Mongo\src\domain\use-cases\customers\delete-city.use-case.ts", "TypeScript", 0, 0, 26, 0, 0, 3, 6, 35
"c:\Users\Usuario\Desktop\Practica Angular\14-Clean-Architecture-Node-Express-Mongo\src\domain\use-cases\customers\delete-customer.use-case.ts", "TypeScript", 0, 0, 26, 0, 0, 3, 6, 35
"c:\Users\Usuario\Desktop\Practica Angular\14-Clean-Architecture-Node-Express-Mongo\src\domain\use-cases\customers\delete-neighborhood.use-case.ts", "TypeScript", 0, 0, 26, 0, 0, 3, 6, 35
"c:\Users\Usuario\Desktop\Practica Angular\14-Clean-Architecture-Node-Express-Mongo\src\domain\use-cases\customers\find-city-by-name.use-case.ts", "TypeScript", 0, 0, 28, 0, 0, 3, 6, 37
"c:\Users\Usuario\Desktop\Practica Angular\14-Clean-Architecture-Node-Express-Mongo\src\domain\use-cases\customers\find-customers-by-neighborhood.use-case.ts", "TypeScript", 0, 0, 31, 0, 0, 3, 6, 40
"c:\Users\Usuario\Desktop\Practica Angular\14-Clean-Architecture-Node-Express-Mongo\src\domain\use-cases\customers\find-neighborhoods-by-city.use-case.ts", "TypeScript", 0, 0, 31, 0, 0, 3, 6, 40
"c:\Users\Usuario\Desktop\Practica Angular\14-Clean-Architecture-Node-Express-Mongo\src\domain\use-cases\customers\get-all-cities.use-case.ts", "TypeScript", 0, 0, 28, 0, 0, 3, 5, 36
"c:\Users\Usuario\Desktop\Practica Angular\14-Clean-Architecture-Node-Express-Mongo\src\domain\use-cases\customers\get-all-customers.use-case.ts", "TypeScript", 0, 0, 28, 0, 0, 3, 5, 36
"c:\Users\Usuario\Desktop\Practica Angular\14-Clean-Architecture-Node-Express-Mongo\src\domain\use-cases\customers\get-all-neighborhoods.use-case.ts", "TypeScript", 0, 0, 28, 0, 0, 3, 5, 36
"c:\Users\Usuario\Desktop\Practica Angular\14-Clean-Architecture-Node-Express-Mongo\src\domain\use-cases\customers\get-city-by-id..use-case.ts", "TypeScript", 0, 0, 25, 0, 0, 2, 5, 32
"c:\Users\Usuario\Desktop\Practica Angular\14-Clean-Architecture-Node-Express-Mongo\src\domain\use-cases\customers\get-customer-by-email.use-case.ts", "TypeScript", 0, 0, 26, 0, 0, 3, 5, 34
"c:\Users\Usuario\Desktop\Practica Angular\14-Clean-Architecture-Node-Express-Mongo\src\domain\use-cases\customers\get-customer-by-id.use-case.ts", "TypeScript", 0, 0, 25, 0, 0, 2, 5, 32
"c:\Users\Usuario\Desktop\Practica Angular\14-Clean-Architecture-Node-Express-Mongo\src\domain\use-cases\customers\get-neighborhood-by-id.use-case.ts", "TypeScript", 0, 0, 25, 0, 0, 2, 5, 32
"c:\Users\Usuario\Desktop\Practica Angular\14-Clean-Architecture-Node-Express-Mongo\src\domain\use-cases\customers\update-city.use-case.ts", "TypeScript", 0, 0, 27, 0, 0, 2, 4, 33
"c:\Users\Usuario\Desktop\Practica Angular\14-Clean-Architecture-Node-Express-Mongo\src\domain\use-cases\customers\update-customer.use-case.ts", "TypeScript", 0, 0, 38, 0, 0, 4, 6, 48
"c:\Users\Usuario\Desktop\Practica Angular\14-Clean-Architecture-Node-Express-Mongo\src\domain\use-cases\customers\update-neighborhood.use-case.ts", "TypeScript", 0, 0, 32, 0, 0, 3, 5, 40
"c:\Users\Usuario\Desktop\Practica Angular\14-Clean-Architecture-Node-Express-Mongo\src\domain\use-cases\product\create-category.use-case.ts", "TypeScript", 0, 0, 33, 0, 0, 4, 15, 52
"c:\Users\Usuario\Desktop\Practica Angular\14-Clean-Architecture-Node-Express-Mongo\src\domain\use-cases\product\create-product.use-case.ts", "TypeScript", 0, 0, 29, 0, 0, 6, 17, 52
"c:\Users\Usuario\Desktop\Practica Angular\14-Clean-Architecture-Node-Express-Mongo\src\domain\use-cases\product\create-unit.use-case.ts", "TypeScript", 0, 0, 31, 0, 0, 5, 13, 49
"c:\Users\Usuario\Desktop\Practica Angular\14-Clean-Architecture-Node-Express-Mongo\src\domain\use-cases\product\delete-category.use-case.ts", "TypeScript", 0, 0, 26, 0, 0, 3, 9, 38
"c:\Users\Usuario\Desktop\Practica Angular\14-Clean-Architecture-Node-Express-Mongo\src\domain\use-cases\product\delete-product.use-case.ts", "TypeScript", 0, 0, 24, 0, 0, 4, 10, 38
"c:\Users\Usuario\Desktop\Practica Angular\14-Clean-Architecture-Node-Express-Mongo\src\domain\use-cases\product\delete-unit.use-case.ts", "TypeScript", 0, 0, 26, 0, 0, 4, 10, 40
"c:\Users\Usuario\Desktop\Practica Angular\14-Clean-Architecture-Node-Express-Mongo\src\domain\use-cases\product\get-all-category.use-case.ts", "TypeScript", 0, 0, 28, 0, 0, 3, 9, 40
"c:\Users\Usuario\Desktop\Practica Angular\14-Clean-Architecture-Node-Express-Mongo\src\domain\use-cases\product\get-all-products.use-case.ts", "TypeScript", 0, 0, 28, 0, 0, 3, 13, 44
"c:\Users\Usuario\Desktop\Practica Angular\14-Clean-Architecture-Node-Express-Mongo\src\domain\use-cases\product\get-all-unit.use-case.ts", "TypeScript", 0, 0, 28, 0, 0, 3, 9, 40
"c:\Users\Usuario\Desktop\Practica Angular\14-Clean-Architecture-Node-Express-Mongo\src\domain\use-cases\product\get-category-by-id.use-case.ts", "TypeScript", 0, 0, 25, 0, 0, 2, 5, 32
"c:\Users\Usuario\Desktop\Practica Angular\14-Clean-Architecture-Node-Express-Mongo\src\domain\use-cases\product\get-product-by-category.use-case.ts", "TypeScript", 0, 0, 32, 0, 0, 4, 14, 50
"c:\Users\Usuario\Desktop\Practica Angular\14-Clean-Architecture-Node-Express-Mongo\src\domain\use-cases\product\get-unit-by-id.use-case.ts", "TypeScript", 0, 0, 26, 0, 0, 2, 5, 33
"c:\Users\Usuario\Desktop\Practica Angular\14-Clean-Architecture-Node-Express-Mongo\src\domain\use-cases\product\update-category.use-case.ts", "TypeScript", 0, 0, 27, 0, 0, 2, 7, 36
"c:\Users\Usuario\Desktop\Practica Angular\14-Clean-Architecture-Node-Express-Mongo\src\domain\use-cases\product\update-product.use-case.ts", "TypeScript", 0, 0, 27, 0, 0, 2, 7, 36
"c:\Users\Usuario\Desktop\Practica Angular\14-Clean-Architecture-Node-Express-Mongo\src\domain\use-cases\product\update-unit.use-case.ts", "TypeScript", 0, 0, 27, 0, 0, 2, 6, 35
"c:\Users\Usuario\Desktop\Practica Angular\14-Clean-Architecture-Node-Express-Mongo\src\domain\use-cases\user\delete-user.use-case.ts", "TypeScript", 0, 0, 0, 0, 0, 0, 1, 1
"c:\Users\Usuario\Desktop\Practica Angular\14-Clean-Architecture-Node-Express-Mongo\src\domain\use-cases\user\update-user.use-case.ts", "TypeScript", 0, 0, 0, 0, 0, 0, 1, 1
"c:\Users\Usuario\Desktop\Practica Angular\14-Clean-Architecture-Node-Express-Mongo\src\infrastructure\datasources\auth.mongo.datasource.impl.ts", "TypeScript", 0, 0, 54, 0, 0, 16, 36, 106
"c:\Users\Usuario\Desktop\Practica Angular\14-Clean-Architecture-Node-Express-Mongo\src\infrastructure\datasources\customers\city.mongo.datasource.impl.ts", "TypeScript", 0, 0, 97, 0, 0, 5, 17, 119
"c:\Users\Usuario\Desktop\Practica Angular\14-Clean-Architecture-Node-Express-Mongo\src\infrastructure\datasources\customers\customer.mongo.datasource.impl.ts", "TypeScript", 0, 0, 154, 0, 0, 6, 25, 185
"c:\Users\Usuario\Desktop\Practica Angular\14-Clean-Architecture-Node-Express-Mongo\src\infrastructure\datasources\customers\neighborhood.mongo.datasource.impl.ts", "TypeScript", 0, 0, 126, 0, 0, 7, 26, 159
"c:\Users\Usuario\Desktop\Practica Angular\14-Clean-Architecture-Node-Express-Mongo\src\infrastructure\datasources\products\category.mongo.datasource.impl.ts", "TypeScript", 0, 0, 88, 0, 0, 22, 54, 164
"c:\Users\Usuario\Desktop\Practica Angular\14-Clean-Architecture-Node-Express-Mongo\src\infrastructure\datasources\products\product.mongo.datasource.impl.ts", "TypeScript", 0, 0, 126, 0, 0, 34, 74, 234
"c:\Users\Usuario\Desktop\Practica Angular\14-Clean-Architecture-Node-Express-Mongo\src\infrastructure\datasources\products\unit.mongo.datasource.impl.ts", "TypeScript", 0, 0, 95, 0, 0, 24, 52, 171
"c:\Users\Usuario\Desktop\Practica Angular\14-Clean-Architecture-Node-Express-Mongo\src\infrastructure\mappers\customers\city.mapper.ts", "TypeScript", 0, 0, 25, 0, 0, 3, 6, 34
"c:\Users\Usuario\Desktop\Practica Angular\14-Clean-Architecture-Node-Express-Mongo\src\infrastructure\mappers\customers\customer.mapper.ts", "TypeScript", 0, 0, 45, 0, 0, 5, 9, 59
"c:\Users\Usuario\Desktop\Practica Angular\14-Clean-Architecture-Node-Express-Mongo\src\infrastructure\mappers\customers\neighborhood.mapper.ts", "TypeScript", 0, 0, 32, 0, 0, 4, 7, 43
"c:\Users\Usuario\Desktop\Practica Angular\14-Clean-Architecture-Node-Express-Mongo\src\infrastructure\mappers\products\category.mapper.ts", "TypeScript", 0, 0, 17, 0, 0, 4, 7, 28
"c:\Users\Usuario\Desktop\Practica Angular\14-Clean-Architecture-Node-Express-Mongo\src\infrastructure\mappers\products\product.mapper.ts", "TypeScript", 0, 0, 27, 0, 0, 4, 6, 37
"c:\Users\Usuario\Desktop\Practica Angular\14-Clean-Architecture-Node-Express-Mongo\src\infrastructure\mappers\products\unit.mapper.ts", "TypeScript", 0, 0, 17, 0, 0, 1, 7, 25
"c:\Users\Usuario\Desktop\Practica Angular\14-Clean-Architecture-Node-Express-Mongo\src\infrastructure\mappers\user.mapper.ts", "TypeScript", 0, 0, 19, 0, 0, 3, 7, 29
"c:\Users\Usuario\Desktop\Practica Angular\14-Clean-Architecture-Node-Express-Mongo\src\infrastructure\repositories\auth.repository.impl.ts", "TypeScript", 0, 0, 16, 0, 0, 0, 7, 23
"c:\Users\Usuario\Desktop\Practica Angular\14-Clean-Architecture-Node-Express-Mongo\src\infrastructure\repositories\customers\city.repository.impl.ts", "TypeScript", 0, 0, 30, 0, 0, 1, 9, 40
"c:\Users\Usuario\Desktop\Practica Angular\14-Clean-Architecture-Node-Express-Mongo\src\infrastructure\repositories\customers\customer.repository.impl.ts", "TypeScript", 0, 0, 30, 0, 0, 1, 9, 40
"c:\Users\Usuario\Desktop\Practica Angular\14-Clean-Architecture-Node-Express-Mongo\src\infrastructure\repositories\customers\neighborhood.repository.impl.ts", "TypeScript", 0, 0, 33, 0, 0, 1, 10, 44
"c:\Users\Usuario\Desktop\Practica Angular\14-Clean-Architecture-Node-Express-Mongo\src\infrastructure\repositories\products\category.respository.impl.ts", "TypeScript", 0, 0, 32, 0, 0, 0, 13, 45
"c:\Users\Usuario\Desktop\Practica Angular\14-Clean-Architecture-Node-Express-Mongo\src\infrastructure\repositories\products\product.repository.impl.ts", "TypeScript", 0, 0, 36, 0, 0, 0, 11, 47
"c:\Users\Usuario\Desktop\Practica Angular\14-Clean-Architecture-Node-Express-Mongo\src\infrastructure\repositories\products\unit.repository.impl.ts", "TypeScript", 0, 0, 30, 0, 0, 0, 9, 39
"c:\Users\Usuario\Desktop\Practica Angular\14-Clean-Architecture-Node-Express-Mongo\src\presentation\auth\controller.auth.ts", "TypeScript", 0, 0, 77, 0, 0, 20, 28, 125
"c:\Users\Usuario\Desktop\Practica Angular\14-Clean-Architecture-Node-Express-Mongo\src\presentation\auth\routes.auth.ts", "TypeScript", 0, 0, 21, 0, 0, 0, 10, 31
"c:\Users\Usuario\Desktop\Practica Angular\14-Clean-Architecture-Node-Express-Mongo\src\presentation\customers\controller.city.ts", "TypeScript", 0, 0, 88, 0, 0, 0, 23, 111
"c:\Users\Usuario\Desktop\Practica Angular\14-Clean-Architecture-Node-Express-Mongo\src\presentation\customers\controller.customer.ts", "TypeScript", 0, 0, 114, 0, 0, 0, 25, 139
"c:\Users\Usuario\Desktop\Practica Angular\14-Clean-Architecture-Node-Express-Mongo\src\presentation\customers\controller.neighborhood.ts", "TypeScript", 0, 0, 101, 0, 0, 0, 23, 124
"c:\Users\Usuario\Desktop\Practica Angular\14-Clean-Architecture-Node-Express-Mongo\src\presentation\customers\routes.city.ts", "TypeScript", 0, 0, 19, 0, 0, 3, 5, 27
"c:\Users\Usuario\Desktop\Practica Angular\14-Clean-Architecture-Node-Express-Mongo\src\presentation\customers\routes.customer.ts", "TypeScript", 0, 0, 24, 0, 0, 3, 5, 32
"c:\Users\Usuario\Desktop\Practica Angular\14-Clean-Architecture-Node-Express-Mongo\src\presentation\customers\routes.neighborhood.ts", "TypeScript", 0, 0, 23, 0, 0, 3, 5, 31
"c:\Users\Usuario\Desktop\Practica Angular\14-Clean-Architecture-Node-Express-Mongo\src\presentation\middlewares\auth.middleware.ts", "TypeScript", 0, 0, 35, 0, 0, 1, 21, 57
"c:\Users\Usuario\Desktop\Practica Angular\14-Clean-Architecture-Node-Express-Mongo\src\presentation\middlewares\rate-limit.middleware.ts", "TypeScript", 0, 0, 72, 0, 0, 4, 9, 85
"c:\Users\Usuario\Desktop\Practica Angular\14-Clean-Architecture-Node-Express-Mongo\src\presentation\products\controller.category.ts", "TypeScript", 0, 0, 75, 0, 0, 14, 33, 122
"c:\Users\Usuario\Desktop\Practica Angular\14-Clean-Architecture-Node-Express-Mongo\src\presentation\products\controller.product.ts", "TypeScript", 0, 0, 85, 0, 0, 17, 31, 133
"c:\Users\Usuario\Desktop\Practica Angular\14-Clean-Architecture-Node-Express-Mongo\src\presentation\products\controller.unit.ts", "TypeScript", 0, 0, 73, 0, 0, 11, 28, 112
"c:\Users\Usuario\Desktop\Practica Angular\14-Clean-Architecture-Node-Express-Mongo\src\presentation\products\routes.category..ts", "TypeScript", 0, 0, 18, 0, 0, 2, 5, 25
"c:\Users\Usuario\Desktop\Practica Angular\14-Clean-Architecture-Node-Express-Mongo\src\presentation\products\routes.product.ts", "TypeScript", 0, 0, 23, 0, 0, 3, 9, 35
"c:\Users\Usuario\Desktop\Practica Angular\14-Clean-Architecture-Node-Express-Mongo\src\presentation\products\routes.unit.ts", "TypeScript", 0, 0, 18, 0, 0, 2, 4, 24
"c:\Users\Usuario\Desktop\Practica Angular\14-Clean-Architecture-Node-Express-Mongo\src\presentation\routes.ts", "TypeScript", 0, 0, 21, 0, 0, 7, 12, 40
"c:\Users\Usuario\Desktop\Practica Angular\14-Clean-Architecture-Node-Express-Mongo\src\presentation\server.ts", "TypeScript", 0, 0, 26, 0, 0, 7, 16, 49
"c:\Users\Usuario\Desktop\Practica Angular\14-Clean-Architecture-Node-Express-Mongo\src\presentation\user\controller.user.ts", "TypeScript", 0, 0, 0, 0, 0, 0, 1, 1
"c:\Users\Usuario\Desktop\Practica Angular\14-Clean-Architecture-Node-Express-Mongo\src\presentation\user\routes.user.ts", "TypeScript", 0, 0, 0, 0, 0, 0, 1, 1
"c:\Users\Usuario\Desktop\Practica Angular\14-Clean-Architecture-Node-Express-Mongo\tsconfig.json", "JSON with Comments", 0, 12, 0, 0, 0, 91, 9, 112
"Total", "-", 2657, 12, 4136, 42, 12, 554, 1315, 8728