"filename", "language", "TypeScript", "comment", "blank", "total"
"c:\Users\Usuario\Desktop\Practica Angular\14-back\src\app.ts", "TypeScript", 16, 3, 4, 23
"c:\Users\Usuario\Desktop\Practica Angular\14-back\src\configs\bcrypt.ts", "TypeScript", 11, 3, 2, 16
"c:\Users\Usuario\Desktop\Practica Angular\14-back\src\configs\cloudinary.ts", "TypeScript", 8, 1, 2, 11
"c:\Users\Usuario\Desktop\Practica Angular\14-back\src\configs\envs.ts", "TypeScript", 26, 5, 18, 49
"c:\Users\Usuario\Desktop\Practica Angular\14-back\src\configs\file-storage.ts", "TypeScript", 3, 5, 2, 10
"c:\Users\Usuario\Desktop\Practica Angular\14-back\src\configs\jwt-personal.ts", "TypeScript", 26, 7, 8, 41
"c:\Users\Usuario\Desktop\Practica Angular\14-back\src\configs\jwt.ts", "TypeScript", 31, 5, 7, 43
"c:\Users\Usuario\Desktop\Practica Angular\14-back\src\configs\logger.ts", "TypeScript", 118, 22, 23, 163
"c:\Users\Usuario\Desktop\Practica Angular\14-back\src\configs\notification.config.ts", "TypeScript", 34, 2, 6, 42
"c:\Users\Usuario\Desktop\Practica Angular\14-back\src\configs\notification.ts", "TypeScript", 1, 1, 1, 3
"c:\Users\Usuario\Desktop\Practica Angular\14-back\src\configs\payment.ts", "TypeScript", 9, 5, 2, 16
"c:\Users\Usuario\Desktop\Practica Angular\14-back\src\configs\validator.ts", "TypeScript", 5, 1, 4, 10
"c:\Users\Usuario\Desktop\Practica Angular\14-back\src\data\mongodb\models\cart\cart.model.ts", "TypeScript", 59, 6, 5, 70
"c:\Users\Usuario\Desktop\Practica Angular\14-back\src\data\mongodb\models\chatbot\chat-models.ts", "TypeScript", 74, 7, 5, 86
"c:\Users\Usuario\Desktop\Practica Angular\14-back\src\data\mongodb\models\coupon\coupon.model.ts", "TypeScript", 83, 4, 5, 92
"c:\Users\Usuario\Desktop\Practica Angular\14-back\src\data\mongodb\models\customers\address.model.ts", "TypeScript", 67, 5, 4, 76
"c:\Users\Usuario\Desktop\Practica Angular\14-back\src\data\mongodb\models\customers\city.model.ts", "TypeScript", 24, 0, 2, 26
"c:\Users\Usuario\Desktop\Practica Angular\14-back\src\data\mongodb\models\customers\customer.model.ts", "TypeScript", 49, 9, 3, 61
"c:\Users\Usuario\Desktop\Practica Angular\14-back\src\data\mongodb\models\customers\neighborhood.model.ts", "TypeScript", 29, 1, 3, 33
"c:\Users\Usuario\Desktop\Practica Angular\14-back\src\data\mongodb\models\order\order-status.model.ts", "TypeScript", 64, 4, 5, 73
"c:\Users\Usuario\Desktop\Practica Angular\14-back\src\data\mongodb\models\order\order.model.ts", "TypeScript", 35, 3, 6, 44
"c:\Users\Usuario\Desktop\Practica Angular\14-back\src\data\mongodb\models\payment\payment-method.model.ts", "TypeScript", 41, 3, 5, 49
"c:\Users\Usuario\Desktop\Practica Angular\14-back\src\data\mongodb\models\payment\payment.model.ts", "TypeScript", 65, 6, 3, 74
"c:\Users\Usuario\Desktop\Practica Angular\14-back\src\data\mongodb\models\products\category.model.ts", "TypeScript", 20, 0, 6, 26
"c:\Users\Usuario\Desktop\Practica Angular\14-back\src\data\mongodb\models\products\product.model.ts", "TypeScript", 73, 8, 5, 86
"c:\Users\Usuario\Desktop\Practica Angular\14-back\src\data\mongodb\models\products\tag.model.ts", "TypeScript", 27, 1, 3, 31
"c:\Users\Usuario\Desktop\Practica Angular\14-back\src\data\mongodb\models\products\unit.model.ts", "TypeScript", 21, 0, 3, 24
"c:\Users\Usuario\Desktop\Practica Angular\14-back\src\data\mongodb\models\sales\sale.model.ts", "TypeScript", 82, 1, 4, 87
"c:\Users\Usuario\Desktop\Practica Angular\14-back\src\data\mongodb\models\user.model.ts", "TypeScript", 33, 3, 7, 43
"c:\Users\Usuario\Desktop\Practica Angular\14-back\src\data\mongodb\mongo-database.ts", "TypeScript", 25, 0, 9, 34
"c:\Users\Usuario\Desktop\Practica Angular\14-back\src\domain\datasources\auth.datasource.ts", "TypeScript", 12, 10, 4, 26
"c:\Users\Usuario\Desktop\Practica Angular\14-back\src\domain\datasources\cart\cart.datasource.ts", "TypeScript", 11, 5, 8, 24
"c:\Users\Usuario\Desktop\Practica Angular\14-back\src\domain\datasources\chatbot\chat.datasource.ts", "TypeScript", 11, 1, 1, 13
"c:\Users\Usuario\Desktop\Practica Angular\14-back\src\domain\datasources\coupon\coupon.datasource.ts", "TypeScript", 13, 3, 3, 19
"c:\Users\Usuario\Desktop\Practica Angular\14-back\src\domain\datasources\customers\city.datasource.ts", "TypeScript", 13, 0, 1, 14
"c:\Users\Usuario\Desktop\Practica Angular\14-back\src\domain\datasources\customers\customer.datasource.ts", "TypeScript", 23, 4, 2, 29
"c:\Users\Usuario\Desktop\Practica Angular\14-back\src\domain\datasources\customers\neighborhood.datasource.ts", "TypeScript", 14, 0, 1, 15
"c:\Users\Usuario\Desktop\Practica Angular\14-back\src\domain\datasources\mcp\mcp.datasource.ts", "TypeScript", 5, 1, 2, 8
"c:\Users\Usuario\Desktop\Practica Angular\14-back\src\domain\datasources\order\order-status.datasource.ts", "TypeScript", 14, 1, 2, 17
"c:\Users\Usuario\Desktop\Practica Angular\14-back\src\domain\datasources\order\order.datasource.ts", "TypeScript", 31, 9, 9, 49
"c:\Users\Usuario\Desktop\Practica Angular\14-back\src\domain\datasources\payment\payment-method.datasource.ts", "TypeScript", 13, 1, 3, 17
"c:\Users\Usuario\Desktop\Practica Angular\14-back\src\domain\datasources\payment\payment.datasource.ts", "TypeScript", 22, 13, 13, 48
"c:\Users\Usuario\Desktop\Practica Angular\14-back\src\domain\datasources\products\category.datasource.ts", "TypeScript", 13, 0, 6, 19
"c:\Users\Usuario\Desktop\Practica Angular\14-back\src\domain\datasources\products\product.datasource.ts", "TypeScript", 17, 1, 1, 19
"c:\Users\Usuario\Desktop\Practica Angular\14-back\src\domain\datasources\products\tag.datasource.ts", "TypeScript", 12, 1, 1, 14
"c:\Users\Usuario\Desktop\Practica Angular\14-back\src\domain\datasources\products\unit.datasource.ts", "TypeScript", 13, 0, 4, 17
"c:\Users\Usuario\Desktop\Practica Angular\14-back\src\domain\datasources\sales\sale.datasource.ts", "TypeScript", 13, 1, 2, 16
"c:\Users\Usuario\Desktop\Practica Angular\14-back\src\domain\dtos\auth\forgot-password.dto.ts", "TypeScript", 12, 1, 5, 18
"c:\Users\Usuario\Desktop\Practica Angular\14-back\src\domain\dtos\auth\login-user.dto.ts", "TypeScript", 14, 1, 10, 25
"c:\Users\Usuario\Desktop\Practica Angular\14-back\src\domain\dtos\auth\register-user.dto.ts", "TypeScript", 17, 12, 13, 42
"c:\Users\Usuario\Desktop\Practica Angular\14-back\src\domain\dtos\auth\reset-password.dto.ts", "TypeScript", 16, 1, 5, 22
"c:\Users\Usuario\Desktop\Practica Angular\14-back\src\domain\dtos\cart\add-item-to-cart.dto.ts", "TypeScript", 18, 1, 5, 24
"c:\Users\Usuario\Desktop\Practica Angular\14-back\src\domain\dtos\cart\update-cart-item.dto.ts", "TypeScript", 18, 2, 5, 25
"c:\Users\Usuario\Desktop\Practica Angular\14-back\src\domain\dtos\chatbot\chat-query.dto.ts", "TypeScript", 24, 3, 5, 32
"c:\Users\Usuario\Desktop\Practica Angular\14-back\src\domain\dtos\coupon\create-coupon.dto.ts", "TypeScript", 69, 2, 12, 83
"c:\Users\Usuario\Desktop\Practica Angular\14-back\src\domain\dtos\coupon\update-coupon.dto.ts", "TypeScript", 105, 5, 15, 125
"c:\Users\Usuario\Desktop\Practica Angular\14-back\src\domain\dtos\customers\create-address.dto.ts", "TypeScript", 57, 5, 6, 68
"c:\Users\Usuario\Desktop\Practica Angular\14-back\src\domain\dtos\customers\create-city.dto.ts", "TypeScript", 24, 4, 5, 33
"c:\Users\Usuario\Desktop\Practica Angular\14-back\src\domain\dtos\customers\create-customer.dto.ts", "TypeScript", 47, 7, 10, 64
"c:\Users\Usuario\Desktop\Practica Angular\14-back\src\domain\dtos\customers\create-neighborhood.dto.ts", "TypeScript", 30, 5, 7, 42
"c:\Users\Usuario\Desktop\Practica Angular\14-back\src\domain\dtos\customers\update-address.dto.ts", "TypeScript", 71, 4, 9, 84
"c:\Users\Usuario\Desktop\Practica Angular\14-back\src\domain\dtos\customers\update-city.dto.ts", "TypeScript", 37, 3, 6, 46
"c:\Users\Usuario\Desktop\Practica Angular\14-back\src\domain\dtos\customers\update-customer.dto.ts", "TypeScript", 66, 3, 11, 80
"c:\Users\Usuario\Desktop\Practica Angular\14-back\src\domain\dtos\customers\update-neighborhood.dto.ts", "TypeScript", 45, 3, 7, 55
"c:\Users\Usuario\Desktop\Practica Angular\14-back\src\domain\dtos\mcp\mcp-call.dto.ts", "TypeScript", 29, 2, 7, 38
"c:\Users\Usuario\Desktop\Practica Angular\14-back\src\domain\dtos\order\create-order-status.dto.ts", "TypeScript", 56, 4, 8, 68
"c:\Users\Usuario\Desktop\Practica Angular\14-back\src\domain\dtos\order\create-order.dto.ts", "TypeScript", 108, 12, 15, 135
"c:\Users\Usuario\Desktop\Practica Angular\14-back\src\domain\dtos\order\select-payment-method.dto.ts", "TypeScript", 27, 4, 8, 39
"c:\Users\Usuario\Desktop\Practica Angular\14-back\src\domain\dtos\order\update-order-status-data.dto.ts", "TypeScript", 76, 6, 12, 94
"c:\Users\Usuario\Desktop\Practica Angular\14-back\src\domain\dtos\order\update-order-status-transitions.dto.ts", "TypeScript", 24, 1, 9, 34
"c:\Users\Usuario\Desktop\Practica Angular\14-back\src\domain\dtos\order\update-order-status.dto.ts", "TypeScript", 32, 2, 7, 41
"c:\Users\Usuario\Desktop\Practica Angular\14-back\src\domain\dtos\order\update-order.dto.ts", "TypeScript", 29, 1, 3, 33
"c:\Users\Usuario\Desktop\Practica Angular\14-back\src\domain\dtos\payment\create-payment-method.dto.ts", "TypeScript", 38, 1, 5, 44
"c:\Users\Usuario\Desktop\Practica Angular\14-back\src\domain\dtos\payment\create-payment.dto.ts", "TypeScript", 74, 4, 9, 87
"c:\Users\Usuario\Desktop\Practica Angular\14-back\src\domain\dtos\payment\process-webhook.dto.ts", "TypeScript", 24, 1, 3, 28
"c:\Users\Usuario\Desktop\Practica Angular\14-back\src\domain\dtos\payment\update-payment-method.dto.ts", "TypeScript", 31, 1, 4, 36
"c:\Users\Usuario\Desktop\Practica Angular\14-back\src\domain\dtos\payment\update-payment-status.dto.ts", "TypeScript", 27, 1, 4, 32
"c:\Users\Usuario\Desktop\Practica Angular\14-back\src\domain\dtos\payment\verify-payment.dto.ts", "TypeScript", 18, 1, 3, 22
"c:\Users\Usuario\Desktop\Practica Angular\14-back\src\domain\dtos\products\create-category.ts", "TypeScript", 15, 7, 7, 29
"c:\Users\Usuario\Desktop\Practica Angular\14-back\src\domain\dtos\products\create-product.dto.ts", "TypeScript", 57, 9, 10, 76
"c:\Users\Usuario\Desktop\Practica Angular\14-back\src\domain\dtos\products\create-tag.dto.ts", "TypeScript", 19, 1, 4, 24
"c:\Users\Usuario\Desktop\Practica Angular\14-back\src\domain\dtos\products\create-unit.dto.ts", "TypeScript", 15, 6, 9, 30
"c:\Users\Usuario\Desktop\Practica Angular\14-back\src\domain\dtos\products\search-product.dto.ts", "TypeScript", 99, 10, 14, 123
"c:\Users\Usuario\Desktop\Practica Angular\14-back\src\domain\dtos\products\udpate-unit.dto.ts", "TypeScript", 34, 7, 10, 51
"c:\Users\Usuario\Desktop\Practica Angular\14-back\src\domain\dtos\products\update-category.dto.ts", "TypeScript", 28, 4, 9, 41
"c:\Users\Usuario\Desktop\Practica Angular\14-back\src\domain\dtos\products\update-product.dto.ts", "TypeScript", 97, 15, 13, 125
"c:\Users\Usuario\Desktop\Practica Angular\14-back\src\domain\dtos\products\update-tag.dto.ts", "TypeScript", 31, 1, 7, 39
"c:\Users\Usuario\Desktop\Practica Angular\14-back\src\domain\dtos\sales\create-sale.dto.ts", "TypeScript", 56, 5, 10, 71
"c:\Users\Usuario\Desktop\Practica Angular\14-back\src\domain\dtos\sales\update-sale-status.dto.ts", "TypeScript", 20, 1, 4, 25
"c:\Users\Usuario\Desktop\Practica Angular\14-back\src\domain\dtos\shared\pagination.dto.ts", "TypeScript", 16, 6, 8, 30
"c:\Users\Usuario\Desktop\Practica Angular\14-back\src\domain\entities\cart\cart-item.entity.ts", "TypeScript", 14, 10, 4, 28
"c:\Users\Usuario\Desktop\Practica Angular\14-back\src\domain\entities\cart\cart.entity.ts", "TypeScript", 16, 18, 6, 40
"c:\Users\Usuario\Desktop\Practica Angular\14-back\src\domain\entities\chatbot\chat-message.entity.ts", "TypeScript", 24, 1, 2, 27
"c:\Users\Usuario\Desktop\Practica Angular\14-back\src\domain\entities\coupon\coupon.entity.ts", "TypeScript", 32, 3, 3, 38
"c:\Users\Usuario\Desktop\Practica Angular\14-back\src\domain\entities\customers\address.entity.ts", "TypeScript", 26, 2, 2, 30
"c:\Users\Usuario\Desktop\Practica Angular\14-back\src\domain\entities\customers\citiy.ts", "TypeScript", 8, 1, 0, 9
"c:\Users\Usuario\Desktop\Practica Angular\14-back\src\domain\entities\customers\customer.ts", "TypeScript", 13, 1, 2, 16
"c:\Users\Usuario\Desktop\Practica Angular\14-back\src\domain\entities\customers\neighborhood.ts", "TypeScript", 10, 1, 3, 14
"c:\Users\Usuario\Desktop\Practica Angular\14-back\src\domain\entities\mcp\mcp.entity.ts", "TypeScript", 21, 1, 4, 26
"c:\Users\Usuario\Desktop\Practica Angular\14-back\src\domain\entities\monitoring\cloudinary-usage.entity.ts", "TypeScript", 120, 4, 17, 141
"c:\Users\Usuario\Desktop\Practica Angular\14-back\src\domain\entities\monitoring\mongodb-usage.entity.ts", "TypeScript", 55, 0, 8, 63
"c:\Users\Usuario\Desktop\Practica Angular\14-back\src\domain\entities\monitoring\render-usage.entity.ts", "TypeScript", 83, 0, 9, 92
"c:\Users\Usuario\Desktop\Practica Angular\14-back\src\domain\entities\order\order-status.entity.ts", "TypeScript", 18, 1, 2, 21
"c:\Users\Usuario\Desktop\Practica Angular\14-back\src\domain\entities\order\order.entity.ts", "TypeScript", 43, 9, 5, 57
"c:\Users\Usuario\Desktop\Practica Angular\14-back\src\domain\entities\payment\payment-method.entity.ts", "TypeScript", 50, 2, 7, 59
"c:\Users\Usuario\Desktop\Practica Angular\14-back\src\domain\entities\payment\payment.entity.ts", "TypeScript", 34, 2, 4, 40
"c:\Users\Usuario\Desktop\Practica Angular\14-back\src\domain\entities\products\category.entity.ts", "TypeScript", 8, 0, 1, 9
"c:\Users\Usuario\Desktop\Practica Angular\14-back\src\domain\entities\products\product.entity.ts", "TypeScript", 18, 1, 4, 23
"c:\Users\Usuario\Desktop\Practica Angular\14-back\src\domain\entities\products\tag.entity.ts", "TypeScript", 10, 1, 0, 11
"c:\Users\Usuario\Desktop\Practica Angular\14-back\src\domain\entities\products\unit.entity.ts", "TypeScript", 8, 0, 2, 10
"c:\Users\Usuario\Desktop\Practica Angular\14-back\src\domain\entities\sales\sale.entity.ts", "TypeScript", 24, 1, 3, 28
"c:\Users\Usuario\Desktop\Practica Angular\14-back\src\domain\entities\user.entity.ts", "TypeScript", 10, 3, 4, 17
"c:\Users\Usuario\Desktop\Practica Angular\14-back\src\domain\errors\custom.error.ts", "TypeScript", 27, 0, 8, 35
"c:\Users\Usuario\Desktop\Practica Angular\14-back\src\domain\interfaces\email.service.ts", "TypeScript", 25, 2, 5, 32
"c:\Users\Usuario\Desktop\Practica Angular\14-back\src\domain\interfaces\file-storage.interface.ts", "TypeScript", 9, 17, 5, 31
"c:\Users\Usuario\Desktop\Practica Angular\14-back\src\domain\interfaces\logger.interface.ts", "TypeScript", 7, 16, 6, 29
"c:\Users\Usuario\Desktop\Practica Angular\14-back\src\domain\interfaces\notification.interface.ts", "TypeScript", 11, 1, 3, 15
"c:\Users\Usuario\Desktop\Practica Angular\14-back\src\domain\interfaces\payment.service.ts", "TypeScript", 112, 1, 11, 124
"c:\Users\Usuario\Desktop\Practica Angular\14-back\src\domain\interfaces\payment\mercado-pago.interface.ts", "TypeScript", 146, 10, 6, 162
"c:\Users\Usuario\Desktop\Practica Angular\14-back\src\domain\interfaces\services\logger.service.ts", "TypeScript", 7, 1, 1, 9
"c:\Users\Usuario\Desktop\Practica Angular\14-back\src\domain\interfaces\services\notification.service.ts", "TypeScript", 16, 1, 1, 18
"c:\Users\Usuario\Desktop\Practica Angular\14-back\src\domain\interfaces\telegram.service.ts", "TypeScript", 17, 1, 4, 22
"c:\Users\Usuario\Desktop\Practica Angular\14-back\src\domain\repositories\auth.repository.ts", "TypeScript", 12, 3, 5, 20
"c:\Users\Usuario\Desktop\Practica Angular\14-back\src\domain\repositories\cart\cart.repository.ts", "TypeScript", 10, 2, 6, 18
"c:\Users\Usuario\Desktop\Practica Angular\14-back\src\domain\repositories\chatbot\chat.repository.ts", "TypeScript", 11, 1, 1, 13
"c:\Users\Usuario\Desktop\Practica Angular\14-back\src\domain\repositories\coupon\coupon.repository.ts", "TypeScript", 13, 2, 3, 18
"c:\Users\Usuario\Desktop\Practica Angular\14-back\src\domain\repositories\customers\city.repository.ts", "TypeScript", 13, 0, 1, 14
"c:\Users\Usuario\Desktop\Practica Angular\14-back\src\domain\repositories\customers\customer.repository.ts", "TypeScript", 23, 4, 2, 29
"c:\Users\Usuario\Desktop\Practica Angular\14-back\src\domain\repositories\customers\neighborhood.repository.ts", "TypeScript", 14, 0, 1, 15
"c:\Users\Usuario\Desktop\Practica Angular\14-back\src\domain\repositories\mcp\mcp.repository.ts", "TypeScript", 5, 1, 2, 8
"c:\Users\Usuario\Desktop\Practica Angular\14-back\src\domain\repositories\order\order-status.repository.ts", "TypeScript", 14, 1, 2, 17
"c:\Users\Usuario\Desktop\Practica Angular\14-back\src\domain\repositories\order\order.repository.ts", "TypeScript", 32, 9, 8, 49
"c:\Users\Usuario\Desktop\Practica Angular\14-back\src\domain\repositories\payment\payment-method.repository.ts", "TypeScript", 13, 1, 3, 17
"c:\Users\Usuario\Desktop\Practica Angular\14-back\src\domain\repositories\payment\payment.repository.ts", "TypeScript", 22, 14, 15, 51
"c:\Users\Usuario\Desktop\Practica Angular\14-back\src\domain\repositories\products\categroy.repository.ts", "TypeScript", 13, 0, 4, 17
"c:\Users\Usuario\Desktop\Practica Angular\14-back\src\domain\repositories\products\product.repository.ts", "TypeScript", 17, 1, 1, 19
"c:\Users\Usuario\Desktop\Practica Angular\14-back\src\domain\repositories\products\tag.repository.ts", "TypeScript", 12, 1, 1, 14
"c:\Users\Usuario\Desktop\Practica Angular\14-back\src\domain\repositories\products\unit.repository.ts", "TypeScript", 13, 0, 2, 15
"c:\Users\Usuario\Desktop\Practica Angular\14-back\src\domain\repositories\sales\sale.repository.ts", "TypeScript", 13, 1, 1, 15
"c:\Users\Usuario\Desktop\Practica Angular\14-back\src\domain\use-cases\auth\login-user.use-case.ts", "TypeScript", 47, 10, 25, 82
"c:\Users\Usuario\Desktop\Practica Angular\14-back\src\domain\use-cases\auth\register-user.use-case.ts", "TypeScript", 88, 34, 17, 139
"c:\Users\Usuario\Desktop\Practica Angular\14-back\src\domain\use-cases\auth\request-password-reset.use-case.ts", "TypeScript", 42, 10, 13, 65
"c:\Users\Usuario\Desktop\Practica Angular\14-back\src\domain\use-cases\auth\reset-password.use-case.ts", "TypeScript", 44, 9, 14, 67
"c:\Users\Usuario\Desktop\Practica Angular\14-back\src\domain\use-cases\cart\add-to-cart.use-case.ts", "TypeScript", 40, 13, 8, 61
"c:\Users\Usuario\Desktop\Practica Angular\14-back\src\domain\use-cases\cart\clear-cart.use-case.ts", "TypeScript", 19, 0, 4, 23
"c:\Users\Usuario\Desktop\Practica Angular\14-back\src\domain\use-cases\cart\get-cart.use-case.ts", "TypeScript", 19, 1, 4, 24
"c:\Users\Usuario\Desktop\Practica Angular\14-back\src\domain\use-cases\cart\remove-from-cart.use-case.ts", "TypeScript", 22, 0, 5, 27
"c:\Users\Usuario\Desktop\Practica Angular\14-back\src\domain\use-cases\cart\update-cart-item.use-case.ts", "TypeScript", 58, 18, 10, 86
"c:\Users\Usuario\Desktop\Practica Angular\14-back\src\domain\use-cases\chatbot\generate-embeddings.use-case.ts", "TypeScript", 18, 1, 2, 21
"c:\Users\Usuario\Desktop\Practica Angular\14-back\src\domain\use-cases\chatbot\query-chatbot.use-case.ts", "TypeScript", 45, 6, 8, 59
"c:\Users\Usuario\Desktop\Practica Angular\14-back\src\domain\use-cases\coupon\create-coupon.use-case.ts", "TypeScript", 23, 3, 4, 30
"c:\Users\Usuario\Desktop\Practica Angular\14-back\src\domain\use-cases\coupon\delete-coupon.use-case.ts", "TypeScript", 21, 3, 3, 27
"c:\Users\Usuario\Desktop\Practica Angular\14-back\src\domain\use-cases\coupon\get-all-coupons.use-case.ts", "TypeScript", 19, 1, 3, 23
"c:\Users\Usuario\Desktop\Practica Angular\14-back\src\domain\use-cases\coupon\get-coupon-by-id.use-case.ts", "TypeScript", 21, 1, 3, 25
"c:\Users\Usuario\Desktop\Practica Angular\14-back\src\domain\use-cases\coupon\update-coupon.use-case.ts", "TypeScript", 39, 5, 7, 51
"c:\Users\Usuario\Desktop\Practica Angular\14-back\src\domain\use-cases\customers\create-address.use-case.ts", "TypeScript", 44, 6, 6, 56
"c:\Users\Usuario\Desktop\Practica Angular\14-back\src\domain\use-cases\customers\create-city.use-case.ts", "TypeScript", 33, 4, 8, 45
"c:\Users\Usuario\Desktop\Practica Angular\14-back\src\domain\use-cases\customers\create-customer.use-case.ts", "TypeScript", 32, 4, 6, 42
"c:\Users\Usuario\Desktop\Practica Angular\14-back\src\domain\use-cases\customers\create-neighborhood.use-case.ts", "TypeScript", 39, 4, 8, 51
"c:\Users\Usuario\Desktop\Practica Angular\14-back\src\domain\use-cases\customers\delete-address.use-case.ts", "TypeScript", 29, 6, 4, 39
"c:\Users\Usuario\Desktop\Practica Angular\14-back\src\domain\use-cases\customers\delete-city.use-case.ts", "TypeScript", 26, 3, 6, 35
"c:\Users\Usuario\Desktop\Practica Angular\14-back\src\domain\use-cases\customers\delete-customer.use-case.ts", "TypeScript", 26, 3, 6, 35
"c:\Users\Usuario\Desktop\Practica Angular\14-back\src\domain\use-cases\customers\delete-neighborhood.use-case.ts", "TypeScript", 26, 3, 6, 35
"c:\Users\Usuario\Desktop\Practica Angular\14-back\src\domain\use-cases\customers\find-city-by-name.use-case.ts", "TypeScript", 28, 3, 6, 37
"c:\Users\Usuario\Desktop\Practica Angular\14-back\src\domain\use-cases\customers\find-customers-by-neighborhood.use-case.ts", "TypeScript", 31, 3, 6, 40
"c:\Users\Usuario\Desktop\Practica Angular\14-back\src\domain\use-cases\customers\find-neighborhoods-by-city.use-case.ts", "TypeScript", 31, 3, 6, 40
"c:\Users\Usuario\Desktop\Practica Angular\14-back\src\domain\use-cases\customers\get-all-cities.use-case.ts", "TypeScript", 28, 3, 5, 36
"c:\Users\Usuario\Desktop\Practica Angular\14-back\src\domain\use-cases\customers\get-all-customers.use-case.ts", "TypeScript", 28, 3, 5, 36
"c:\Users\Usuario\Desktop\Practica Angular\14-back\src\domain\use-cases\customers\get-all-neighborhoods.use-case.ts", "TypeScript", 28, 3, 5, 36
"c:\Users\Usuario\Desktop\Practica Angular\14-back\src\domain\use-cases\customers\get-city-by-id..use-case.ts", "TypeScript", 25, 2, 5, 32
"c:\Users\Usuario\Desktop\Practica Angular\14-back\src\domain\use-cases\customers\get-customer-by-email.use-case.ts", "TypeScript", 26, 3, 5, 34
"c:\Users\Usuario\Desktop\Practica Angular\14-back\src\domain\use-cases\customers\get-customer-by-id.use-case.ts", "TypeScript", 25, 2, 5, 32
"c:\Users\Usuario\Desktop\Practica Angular\14-back\src\domain\use-cases\customers\get-my-addresses.use-case.ts", "TypeScript", 29, 7, 5, 41
"c:\Users\Usuario\Desktop\Practica Angular\14-back\src\domain\use-cases\customers\get-neighborhood-by-id.use-case.ts", "TypeScript", 25, 2, 5, 32
"c:\Users\Usuario\Desktop\Practica Angular\14-back\src\domain\use-cases\customers\set-default-address.use-case.ts", "TypeScript", 39, 7, 7, 53
"c:\Users\Usuario\Desktop\Practica Angular\14-back\src\domain\use-cases\customers\update-address.use-case.ts", "TypeScript", 54, 9, 7, 70
"c:\Users\Usuario\Desktop\Practica Angular\14-back\src\domain\use-cases\customers\update-city.use-case.ts", "TypeScript", 27, 2, 4, 33
"c:\Users\Usuario\Desktop\Practica Angular\14-back\src\domain\use-cases\customers\update-customer.use-case.ts", "TypeScript", 38, 4, 6, 48
"c:\Users\Usuario\Desktop\Practica Angular\14-back\src\domain\use-cases\customers\update-neighborhood.use-case.ts", "TypeScript", 32, 3, 5, 40
"c:\Users\Usuario\Desktop\Practica Angular\14-back\src\domain\use-cases\mcp\call-tool.use-case.ts", "TypeScript", 22, 1, 3, 26
"c:\Users\Usuario\Desktop\Practica Angular\14-back\src\domain\use-cases\mcp\list-tools.use-case.ts", "TypeScript", 10, 1, 3, 14
"c:\Users\Usuario\Desktop\Practica Angular\14-back\src\domain\use-cases\monitoring\monitor-cloudinary-usage.use-case.ts", "TypeScript", 240, 21, 38, 299
"c:\Users\Usuario\Desktop\Practica Angular\14-back\src\domain\use-cases\monitoring\monitor-mongodb-usage.use-case.ts", "TypeScript", 141, 16, 23, 180
"c:\Users\Usuario\Desktop\Practica Angular\14-back\src\domain\use-cases\monitoring\monitor-render-usage.use-case.ts", "TypeScript", 165, 14, 36, 215
"c:\Users\Usuario\Desktop\Practica Angular\14-back\src\domain\use-cases\notification\notify-order.use-case.ts", "TypeScript", 69, 3, 7, 79
"c:\Users\Usuario\Desktop\Practica Angular\14-back\src\domain\use-cases\notifications\notify-order.use-case.ts", "TypeScript", 66, 3, 6, 75
"c:\Users\Usuario\Desktop\Practica Angular\14-back\src\domain\use-cases\order\create-order-status.use-case.ts", "TypeScript", 28, 2, 7, 37
"c:\Users\Usuario\Desktop\Practica Angular\14-back\src\domain\use-cases\order\create-order.use-case.ts", "TypeScript", 176, 11, 20, 207
"c:\Users\Usuario\Desktop\Practica Angular\14-back\src\domain\use-cases\order\delete-order-status.use-case.ts", "TypeScript", 30, 3, 8, 41
"c:\Users\Usuario\Desktop\Practica Angular\14-back\src\domain\use-cases\order\find-order-by-customer.use-case.ts", "TypeScript", 28, 8, 7, 43
"c:\Users\Usuario\Desktop\Practica Angular\14-back\src\domain\use-cases\order\find-order-by-date-range.use-case.ts", "TypeScript", 28, 8, 7, 43
"c:\Users\Usuario\Desktop\Practica Angular\14-back\src\domain\use-cases\order\get-all-order-statuses.use-case.ts", "TypeScript", 24, 1, 6, 31
"c:\Users\Usuario\Desktop\Practica Angular\14-back\src\domain\use-cases\order\get-all-order.use-case.ts", "TypeScript", 25, 8, 5, 38
"c:\Users\Usuario\Desktop\Practica Angular\14-back\src\domain\use-cases\order\get-my-orders.use-case.ts", "TypeScript", 36, 8, 9, 53
"c:\Users\Usuario\Desktop\Practica Angular\14-back\src\domain\use-cases\order\get-order-by-id.use-case.ts", "TypeScript", 25, 2, 5, 32
"c:\Users\Usuario\Desktop\Practica Angular\14-back\src\domain\use-cases\order\get-orders-for-dashboard.use-case.ts", "TypeScript", 52, 18, 17, 87
"c:\Users\Usuario\Desktop\Practica Angular\14-back\src\domain\use-cases\order\select-payment-method.use-case.ts", "TypeScript", 85, 14, 20, 119
"c:\Users\Usuario\Desktop\Practica Angular\14-back\src\domain\use-cases\order\update-order-status-data.use-case.ts", "TypeScript", 59, 7, 9, 75
"c:\Users\Usuario\Desktop\Practica Angular\14-back\src\domain\use-cases\order\update-order-status-transitions.use-case.ts", "TypeScript", 59, 8, 10, 77
"c:\Users\Usuario\Desktop\Practica Angular\14-back\src\domain\use-cases\order\update-order-status.use-case.ts", "TypeScript", 53, 4, 10, 67
"c:\Users\Usuario\Desktop\Practica Angular\14-back\src\domain\use-cases\order\update-order.use-case.ts", "TypeScript", 9, 0, 2, 11
"c:\Users\Usuario\Desktop\Practica Angular\14-back\src\domain\use-cases\order\validate-order-status-transition.use-case.ts", "TypeScript", 36, 3, 9, 48
"c:\Users\Usuario\Desktop\Practica Angular\14-back\src\domain\use-cases\payment\create-payment-method.use-case.ts", "TypeScript", 14, 1, 6, 21
"c:\Users\Usuario\Desktop\Practica Angular\14-back\src\domain\use-cases\payment\create-payment.use-case.ts", "TypeScript", 68, 8, 11, 87
"c:\Users\Usuario\Desktop\Practica Angular\14-back\src\domain\use-cases\payment\delete-payment-method.use-case.ts", "TypeScript", 13, 1, 6, 20
"c:\Users\Usuario\Desktop\Practica Angular\14-back\src\domain\use-cases\payment\get-active-payment-methods.use-case.ts", "TypeScript", 13, 1, 6, 20
"c:\Users\Usuario\Desktop\Practica Angular\14-back\src\domain\use-cases\payment\get-all-payments.use-case.ts", "TypeScript", 21, 0, 3, 24
"c:\Users\Usuario\Desktop\Practica Angular\14-back\src\domain\use-cases\payment\get-payment-by-order.use-case.ts", "TypeScript", 29, 2, 5, 36
"c:\Users\Usuario\Desktop\Practica Angular\14-back\src\domain\use-cases\payment\get-payment-method-by-code.use-case.ts", "TypeScript", 13, 1, 6, 20
"c:\Users\Usuario\Desktop\Practica Angular\14-back\src\domain\use-cases\payment\get-payment-method-by-id.use-case.ts", "TypeScript", 13, 1, 6, 20
"c:\Users\Usuario\Desktop\Practica Angular\14-back\src\domain\use-cases\payment\get-payment-methods.use-case.ts", "TypeScript", 14, 1, 6, 21
"c:\Users\Usuario\Desktop\Practica Angular\14-back\src\domain\use-cases\payment\get-payment.use-case.ts", "TypeScript", 20, 0, 3, 23
"c:\Users\Usuario\Desktop\Practica Angular\14-back\src\domain\use-cases\payment\process-webhook.use-case.ts", "TypeScript", 32, 2, 5, 39
"c:\Users\Usuario\Desktop\Practica Angular\14-back\src\domain\use-cases\payment\update-payment-method.use-case.ts", "TypeScript", 14, 1, 6, 21
"c:\Users\Usuario\Desktop\Practica Angular\14-back\src\domain\use-cases\payment\verify-payment.use-case.ts", "TypeScript", 62, 6, 10, 78
"c:\Users\Usuario\Desktop\Practica Angular\14-back\src\domain\use-cases\product\create-category.use-case.ts", "TypeScript", 33, 4, 15, 52
"c:\Users\Usuario\Desktop\Practica Angular\14-back\src\domain\use-cases\product\create-product.use-case.ts", "TypeScript", 41, 6, 17, 64
"c:\Users\Usuario\Desktop\Practica Angular\14-back\src\domain\use-cases\product\create-unit.use-case.ts", "TypeScript", 31, 5, 13, 49
"c:\Users\Usuario\Desktop\Practica Angular\14-back\src\domain\use-cases\product\delete-category.use-case.ts", "TypeScript", 26, 3, 9, 38
"c:\Users\Usuario\Desktop\Practica Angular\14-back\src\domain\use-cases\product\delete-product.use-case.ts", "TypeScript", 24, 5, 10, 39
"c:\Users\Usuario\Desktop\Practica Angular\14-back\src\domain\use-cases\product\delete-unit.use-case.ts", "TypeScript", 26, 4, 10, 40
"c:\Users\Usuario\Desktop\Practica Angular\14-back\src\domain\use-cases\product\get-all-category.use-case.ts", "TypeScript", 28, 3, 9, 40
"c:\Users\Usuario\Desktop\Practica Angular\14-back\src\domain\use-cases\product\get-all-products.use-case.ts", "TypeScript", 26, 8, 7, 41
"c:\Users\Usuario\Desktop\Practica Angular\14-back\src\domain\use-cases\product\get-all-unit.use-case.ts", "TypeScript", 28, 3, 9, 40
"c:\Users\Usuario\Desktop\Practica Angular\14-back\src\domain\use-cases\product\get-category-by-id.use-case.ts", "TypeScript", 25, 2, 5, 32
"c:\Users\Usuario\Desktop\Practica Angular\14-back\src\domain\use-cases\product\get-product-by-category.use-case.ts", "TypeScript", 27, 7, 6, 40
"c:\Users\Usuario\Desktop\Practica Angular\14-back\src\domain\use-cases\product\get-unit-by-id.use-case.ts", "TypeScript", 26, 2, 5, 33
"c:\Users\Usuario\Desktop\Practica Angular\14-back\src\domain\use-cases\product\search-products.use-case.ts", "TypeScript", 26, 2, 3, 31
"c:\Users\Usuario\Desktop\Practica Angular\14-back\src\domain\use-cases\product\tag\create-tag.use-case.ts", "TypeScript", 15, 1, 4, 20
"c:\Users\Usuario\Desktop\Practica Angular\14-back\src\domain\use-cases\product\tag\delete-tag.use-case.ts", "TypeScript", 14, 2, 3, 19
"c:\Users\Usuario\Desktop\Practica Angular\14-back\src\domain\use-cases\product\tag\get-all-tags.use-case.ts", "TypeScript", 12, 1, 3, 16
"c:\Users\Usuario\Desktop\Practica Angular\14-back\src\domain\use-cases\product\tag\get-tag-by-id.use-case.ts", "TypeScript", 14, 1, 3, 18
"c:\Users\Usuario\Desktop\Practica Angular\14-back\src\domain\use-cases\product\tag\update-tag.use-case.ts", "TypeScript", 21, 2, 5, 28
"c:\Users\Usuario\Desktop\Practica Angular\14-back\src\domain\use-cases\product\update-category.use-case.ts", "TypeScript", 27, 2, 7, 36
"c:\Users\Usuario\Desktop\Practica Angular\14-back\src\domain\use-cases\product\update-product.use-case.ts", "TypeScript", 28, 5, 8, 41
"c:\Users\Usuario\Desktop\Practica Angular\14-back\src\domain\use-cases\product\update-unit.use-case.ts", "TypeScript", 27, 2, 6, 35
"c:\Users\Usuario\Desktop\Practica Angular\14-back\src\domain\use-cases\sales\create-sale.use-case.ts", "TypeScript", 32, 5, 8, 45
"c:\Users\Usuario\Desktop\Practica Angular\14-back\src\domain\use-cases\sales\get-all-sales.use-case.ts", "TypeScript", 14, 1, 5, 20
"c:\Users\Usuario\Desktop\Practica Angular\14-back\src\domain\use-cases\sales\get-sale-by-id.use-case.ts", "TypeScript", 18, 1, 5, 24
"c:\Users\Usuario\Desktop\Practica Angular\14-back\src\domain\use-cases\sales\get-sales-by-customer.use-case.ts", "TypeScript", 14, 1, 5, 20
"c:\Users\Usuario\Desktop\Practica Angular\14-back\src\domain\use-cases\sales\get-sales-by-status.use-case.ts", "TypeScript", 14, 1, 5, 20
"c:\Users\Usuario\Desktop\Practica Angular\14-back\src\domain\use-cases\sales\update-sale-status.use-case.ts", "TypeScript", 25, 4, 8, 37
"c:\Users\Usuario\Desktop\Practica Angular\14-back\src\domain\use-cases\user\delete-user.use-case.ts", "TypeScript", 0, 0, 1, 1
"c:\Users\Usuario\Desktop\Practica Angular\14-back\src\domain\use-cases\user\update-user.use-case.ts", "TypeScript", 0, 0, 1, 1
"c:\Users\Usuario\Desktop\Practica Angular\14-back\src\infrastructure\adapters\cloudinary-file-storage.adapter.ts", "TypeScript", 55, 5, 13, 73
"c:\Users\Usuario\Desktop\Practica Angular\14-back\src\infrastructure\adapters\cloudinary.adapter.ts", "TypeScript", 50, 6, 10, 66
"c:\Users\Usuario\Desktop\Practica Angular\14-back\src\infrastructure\adapters\langchain.adapter.ts", "TypeScript", 144, 12, 19, 175
"c:\Users\Usuario\Desktop\Practica Angular\14-back\src\infrastructure\adapters\llm.adapter.ts", "TypeScript", 100, 6, 17, 123
"c:\Users\Usuario\Desktop\Practica Angular\14-back\src\infrastructure\adapters\mercado-pago-payment.adapter.ts", "TypeScript", 233, 4, 38, 275
"c:\Users\Usuario\Desktop\Practica Angular\14-back\src\infrastructure\adapters\mercado-pago.adapter.ts", "TypeScript", 154, 13, 30, 197
"c:\Users\Usuario\Desktop\Practica Angular\14-back\src\infrastructure\adapters\nodemailer.adapter.ts", "TypeScript", 75, 15, 13, 103
"c:\Users\Usuario\Desktop\Practica Angular\14-back\src\infrastructure\adapters\telegram-notification.adapter.ts", "TypeScript", 89, 2, 16, 107
"c:\Users\Usuario\Desktop\Practica Angular\14-back\src\infrastructure\adapters\telegram.adapter.ts", "TypeScript", 67, 1, 12, 80
"c:\Users\Usuario\Desktop\Practica Angular\14-back\src\infrastructure\adapters\transformers.adapter.ts", "TypeScript", 63, 1, 13, 77
"c:\Users\Usuario\Desktop\Practica Angular\14-back\src\infrastructure\adapters\winston-logger.adapter.ts", "TypeScript", 29, 3, 8, 40
"c:\Users\Usuario\Desktop\Practica Angular\14-back\src\infrastructure\datasources\auth.mongo.datasource.impl.ts", "TypeScript", 135, 13, 19, 167
"c:\Users\Usuario\Desktop\Practica Angular\14-back\src\infrastructure\datasources\cart\cart.mongo.datasource.impl.ts", "TypeScript", 181, 16, 32, 229
"c:\Users\Usuario\Desktop\Practica Angular\14-back\src\infrastructure\datasources\chatbot\chat.mongo.datasource.impl.ts", "TypeScript", 458, 53, 91, 602
"c:\Users\Usuario\Desktop\Practica Angular\14-back\src\infrastructure\datasources\coupon\coupon.mongo.datasource.impl.ts", "TypeScript", 131, 10, 16, 157
"c:\Users\Usuario\Desktop\Practica Angular\14-back\src\infrastructure\datasources\customers\city.mongo.datasource.impl.ts", "TypeScript", 97, 5, 17, 119
"c:\Users\Usuario\Desktop\Practica Angular\14-back\src\infrastructure\datasources\customers\customer.mongo.datasource.impl.ts", "TypeScript", 370, 16, 28, 414
"c:\Users\Usuario\Desktop\Practica Angular\14-back\src\infrastructure\datasources\customers\neighborhood.mongo.datasource.impl.ts", "TypeScript", 126, 7, 26, 159
"c:\Users\Usuario\Desktop\Practica Angular\14-back\src\infrastructure\datasources\mcp\mcp.datasource.impl.ts", "TypeScript", 353, 4, 35, 392
"c:\Users\Usuario\Desktop\Practica Angular\14-back\src\infrastructure\datasources\order\order-status.mongo.datasource.impl.ts", "TypeScript", 162, 7, 41, 210
"c:\Users\Usuario\Desktop\Practica Angular\14-back\src\infrastructure\datasources\order\order.mongo.datasource.impl.ts", "TypeScript", 499, 35, 71, 605
"c:\Users\Usuario\Desktop\Practica Angular\14-back\src\infrastructure\datasources\payment\payment-method.mongo.datasource.impl.ts", "TypeScript", 145, 6, 34, 185
"c:\Users\Usuario\Desktop\Practica Angular\14-back\src\infrastructure\datasources\payment\payment.mongo.datasource.impl.ts", "TypeScript", 343, 22, 43, 408
"c:\Users\Usuario\Desktop\Practica Angular\14-back\src\infrastructure\datasources\products\category.mongo.datasource.impl.ts", "TypeScript", 88, 22, 54, 164
"c:\Users\Usuario\Desktop\Practica Angular\14-back\src\infrastructure\datasources\products\product.mongo.datasource.impl.ts", "TypeScript", 263, 17, 25, 305
"c:\Users\Usuario\Desktop\Practica Angular\14-back\src\infrastructure\datasources\products\tag.mongo.datasource.impl.ts", "TypeScript", 104, 6, 13, 123
"c:\Users\Usuario\Desktop\Practica Angular\14-back\src\infrastructure\datasources\products\unit.mongo.datasource.impl.ts", "TypeScript", 95, 24, 52, 171
"c:\Users\Usuario\Desktop\Practica Angular\14-back\src\infrastructure\datasources\sales\sale.mongo.datasource.impl.ts", "TypeScript", 254, 10, 32, 296
"c:\Users\Usuario\Desktop\Practica Angular\14-back\src\infrastructure\mappers\cart\cart-item.mapper.ts", "TypeScript", 74, 20, 10, 104
"c:\Users\Usuario\Desktop\Practica Angular\14-back\src\infrastructure\mappers\cart\cart.mapper.ts", "TypeScript", 54, 7, 7, 68
"c:\Users\Usuario\Desktop\Practica Angular\14-back\src\infrastructure\mappers\coupon\coupon.mapper.ts", "TypeScript", 33, 2, 5, 40
"c:\Users\Usuario\Desktop\Practica Angular\14-back\src\infrastructure\mappers\customers\address.mapper.ts", "TypeScript", 73, 2, 7, 82
"c:\Users\Usuario\Desktop\Practica Angular\14-back\src\infrastructure\mappers\customers\city.mapper.ts", "TypeScript", 25, 3, 6, 34
"c:\Users\Usuario\Desktop\Practica Angular\14-back\src\infrastructure\mappers\customers\customer.mapper.ts", "TypeScript", 55, 10, 10, 75
"c:\Users\Usuario\Desktop\Practica Angular\14-back\src\infrastructure\mappers\customers\neighborhood.mapper.ts", "TypeScript", 32, 4, 7, 43
"c:\Users\Usuario\Desktop\Practica Angular\14-back\src\infrastructure\mappers\order\order-status.mapper.ts", "TypeScript", 19, 1, 3, 23
"c:\Users\Usuario\Desktop\Practica Angular\14-back\src\infrastructure\mappers\order\order.mapper.ts", "TypeScript", 141, 8, 7, 156
"c:\Users\Usuario\Desktop\Practica Angular\14-back\src\infrastructure\mappers\payment\payment-method.mapper.ts", "TypeScript", 49, 1, 5, 55
"c:\Users\Usuario\Desktop\Practica Angular\14-back\src\infrastructure\mappers\payment\payment.mapper.ts", "TypeScript", 127, 6, 8, 141
"c:\Users\Usuario\Desktop\Practica Angular\14-back\src\infrastructure\mappers\products\category.mapper.ts", "TypeScript", 17, 7, 7, 31
"c:\Users\Usuario\Desktop\Practica Angular\14-back\src\infrastructure\mappers\products\product.mapper.ts", "TypeScript", 72, 13, 11, 96
"c:\Users\Usuario\Desktop\Practica Angular\14-back\src\infrastructure\mappers\products\tag.mapper.ts", "TypeScript", 17, 1, 3, 21
"c:\Users\Usuario\Desktop\Practica Angular\14-back\src\infrastructure\mappers\products\unit.mapper.ts", "TypeScript", 17, 7, 5, 29
"c:\Users\Usuario\Desktop\Practica Angular\14-back\src\infrastructure\mappers\sales\sale.mapper.ts", "TypeScript", 100, 11, 11, 122
"c:\Users\Usuario\Desktop\Practica Angular\14-back\src\infrastructure\mappers\user.mapper.ts", "TypeScript", 19, 4, 5, 28
"c:\Users\Usuario\Desktop\Practica Angular\14-back\src\infrastructure\notifications\email.channel.ts", "TypeScript", 64, 1, 9, 74
"c:\Users\Usuario\Desktop\Practica Angular\14-back\src\infrastructure\notifications\telegram.channel.ts", "TypeScript", 24, 1, 8, 33
"c:\Users\Usuario\Desktop\Practica Angular\14-back\src\infrastructure\repositories\auth.repository.impl.ts", "TypeScript", 29, 3, 9, 41
"c:\Users\Usuario\Desktop\Practica Angular\14-back\src\infrastructure\repositories\cart\cart.repository.impl.ts", "TypeScript", 25, 0, 7, 32
"c:\Users\Usuario\Desktop\Practica Angular\14-back\src\infrastructure\repositories\chatbot\chat.repository.impl.ts", "TypeScript", 30, 1, 8, 39
"c:\Users\Usuario\Desktop\Practica Angular\14-back\src\infrastructure\repositories\coupon\coupon.repository.impl.ts", "TypeScript", 32, 1, 9, 42
"c:\Users\Usuario\Desktop\Practica Angular\14-back\src\infrastructure\repositories\customers\city.repository.impl.ts", "TypeScript", 30, 1, 9, 40
"c:\Users\Usuario\Desktop\Practica Angular\14-back\src\infrastructure\repositories\customers\customer.repository.impl.ts", "TypeScript", 54, 4, 4, 62
"c:\Users\Usuario\Desktop\Practica Angular\14-back\src\infrastructure\repositories\customers\neighborhood.repository.impl.ts", "TypeScript", 33, 1, 10, 44
"c:\Users\Usuario\Desktop\Practica Angular\14-back\src\infrastructure\repositories\mcp\mcp.repository.impl.ts", "TypeScript", 16, 1, 4, 21
"c:\Users\Usuario\Desktop\Practica Angular\14-back\src\infrastructure\repositories\order\order-status.repository.impl.ts", "TypeScript", 35, 1, 10, 46
"c:\Users\Usuario\Desktop\Practica Angular\14-back\src\infrastructure\repositories\order\order.repository.impl.ts", "TypeScript", 53, 9, 10, 72
"c:\Users\Usuario\Desktop\Practica Angular\14-back\src\infrastructure\repositories\payment\payment-method.repository.impl.ts", "TypeScript", 30, 1, 11, 42
"c:\Users\Usuario\Desktop\Practica Angular\14-back\src\infrastructure\repositories\payment\payment.repository.impl.ts", "TypeScript", 51, 1, 16, 68
"c:\Users\Usuario\Desktop\Practica Angular\14-back\src\infrastructure\repositories\products\category.respository.impl.ts", "TypeScript", 32, 0, 13, 45
"c:\Users\Usuario\Desktop\Practica Angular\14-back\src\infrastructure\repositories\products\product.repository.impl.ts", "TypeScript", 40, 3, 4, 47
"c:\Users\Usuario\Desktop\Practica Angular\14-back\src\infrastructure\repositories\products\tag.repository.impl.ts", "TypeScript", 27, 1, 2, 30
"c:\Users\Usuario\Desktop\Practica Angular\14-back\src\infrastructure\repositories\products\unit.repository.impl.ts", "TypeScript", 30, 0, 9, 39
"c:\Users\Usuario\Desktop\Practica Angular\14-back\src\infrastructure\repositories\sales\sale.repository.impl.ts", "TypeScript", 31, 1, 8, 40
"c:\Users\Usuario\Desktop\Practica Angular\14-back\src\infrastructure\services\notification.service.impl.ts", "TypeScript", 64, 1, 7, 72
"c:\Users\Usuario\Desktop\Practica Angular\14-back\src\infrastructure\services\notification.service.ts", "TypeScript", 82, 2, 11, 95
"c:\Users\Usuario\Desktop\Practica Angular\14-back\src\presentation\admin\coupons\routes.admin.coupon.ts", "TypeScript", 18, 3, 4, 25
"c:\Users\Usuario\Desktop\Practica Angular\14-back\src\presentation\admin\customers\routes.admin.city.ts", "TypeScript", 19, 3, 4, 26
"c:\Users\Usuario\Desktop\Practica Angular\14-back\src\presentation\admin\customers\routes.admin.customer.ts", "TypeScript", 24, 3, 4, 31
"c:\Users\Usuario\Desktop\Practica Angular\14-back\src\presentation\admin\customers\routes.admin.neighborhood.ts", "TypeScript", 23, 3, 4, 30
"c:\Users\Usuario\Desktop\Practica Angular\14-back\src\presentation\admin\orders\routes.admin.order.ts", "TypeScript", 62, 3, 5, 70
"c:\Users\Usuario\Desktop\Practica Angular\14-back\src\presentation\admin\products\routes.admin.category.ts", "TypeScript", 18, 1, 3, 22
"c:\Users\Usuario\Desktop\Practica Angular\14-back\src\presentation\admin\products\routes.admin.product.ts", "TypeScript", 30, 3, 5, 38
"c:\Users\Usuario\Desktop\Practica Angular\14-back\src\presentation\admin\products\routes.admin.unit.ts", "TypeScript", 18, 3, 4, 25
"c:\Users\Usuario\Desktop\Practica Angular\14-back\src\presentation\admin\routes.admin.ts", "TypeScript", 30, 3, 4, 37
"c:\Users\Usuario\Desktop\Practica Angular\14-back\src\presentation\admin\tags\routes.admin.tag.ts", "TypeScript", 18, 3, 4, 25
"c:\Users\Usuario\Desktop\Practica Angular\14-back\src\presentation\admin\users\routes.admin.user.ts", "TypeScript", 23, 3, 5, 31
"c:\Users\Usuario\Desktop\Practica Angular\14-back\src\presentation\auth\controller.auth.ts", "TypeScript", 143, 17, 21, 181
"c:\Users\Usuario\Desktop\Practica Angular\14-back\src\presentation\auth\routes.auth.ts", "TypeScript", 29, 5, 7, 41
"c:\Users\Usuario\Desktop\Practica Angular\14-back\src\presentation\cart\controller.cart.ts", "TypeScript", 128, 3, 16, 147
"c:\Users\Usuario\Desktop\Practica Angular\14-back\src\presentation\cart\routes.cart.ts", "TypeScript", 24, 4, 8, 36
"c:\Users\Usuario\Desktop\Practica Angular\14-back\src\presentation\chatbot\controller.chatbot.ts", "TypeScript", 98, 10, 21, 129
"c:\Users\Usuario\Desktop\Practica Angular\14-back\src\presentation\chatbot\routes.chatbot.ts", "TypeScript", 22, 4, 6, 32
"c:\Users\Usuario\Desktop\Practica Angular\14-back\src\presentation\coupon\controller.coupon.ts", "TypeScript", 80, 2, 16, 98
"c:\Users\Usuario\Desktop\Practica Angular\14-back\src\presentation\coupon\routes.coupon.ts", "TypeScript", 20, 6, 6, 32
"c:\Users\Usuario\Desktop\Practica Angular\14-back\src\presentation\customers\controller.address.ts", "TypeScript", 70, 6, 14, 90
"c:\Users\Usuario\Desktop\Practica Angular\14-back\src\presentation\customers\controller.city.ts", "TypeScript", 88, 0, 23, 111
"c:\Users\Usuario\Desktop\Practica Angular\14-back\src\presentation\customers\controller.customer.ts", "TypeScript", 114, 0, 25, 139
"c:\Users\Usuario\Desktop\Practica Angular\14-back\src\presentation\customers\controller.neighborhood.ts", "TypeScript", 101, 0, 23, 124
"c:\Users\Usuario\Desktop\Practica Angular\14-back\src\presentation\customers\routes.address.ts", "TypeScript", 24, 5, 5, 34
"c:\Users\Usuario\Desktop\Practica Angular\14-back\src\presentation\customers\routes.city.ts", "TypeScript", 19, 3, 5, 27
"c:\Users\Usuario\Desktop\Practica Angular\14-back\src\presentation\customers\routes.customer.ts", "TypeScript", 24, 3, 5, 32
"c:\Users\Usuario\Desktop\Practica Angular\14-back\src\presentation\customers\routes.neighborhood.ts", "TypeScript", 23, 3, 5, 31
"c:\Users\Usuario\Desktop\Practica Angular\14-back\src\presentation\mcp\controller.mcp.ts", "TypeScript", 73, 11, 20, 104
"c:\Users\Usuario\Desktop\Practica Angular\14-back\src\presentation\mcp\routes.mcp.ts", "TypeScript", 11, 3, 5, 19
"c:\Users\Usuario\Desktop\Practica Angular\14-back\src\presentation\middlewares\auth.middleware.ts", "TypeScript", 66, 2, 16, 84
"c:\Users\Usuario\Desktop\Practica Angular\14-back\src\presentation\middlewares\logger.middleware.ts", "TypeScript", 141, 25, 27, 193
"c:\Users\Usuario\Desktop\Practica Angular\14-back\src\presentation\middlewares\rate-limit.middleware.ts", "TypeScript", 95, 10, 15, 120
"c:\Users\Usuario\Desktop\Practica Angular\14-back\src\presentation\middlewares\upload.middleware.ts", "TypeScript", 61, 13, 8, 82
"c:\Users\Usuario\Desktop\Practica Angular\14-back\src\presentation\monitoring\controller.monitoring.ts", "TypeScript", 433, 8, 29, 470
"c:\Users\Usuario\Desktop\Practica Angular\14-back\src\presentation\monitoring\routes.monitoring.ts", "TypeScript", 18, 2, 5, 25
"c:\Users\Usuario\Desktop\Practica Angular\14-back\src\presentation\order\controller.order-status.ts", "TypeScript", 137, 11, 28, 176
"c:\Users\Usuario\Desktop\Practica Angular\14-back\src\presentation\order\controller.order.ts", "TypeScript", 230, 10, 29, 269
"c:\Users\Usuario\Desktop\Practica Angular\14-back\src\presentation\order\routes.order-status.ts", "TypeScript", 53, 5, 6, 64
"c:\Users\Usuario\Desktop\Practica Angular\14-back\src\presentation\order\routes.order.ts", "TypeScript", 65, 6, 5, 76
"c:\Users\Usuario\Desktop\Practica Angular\14-back\src\presentation\payment\controller.payment-method.ts", "TypeScript", 107, 8, 22, 137
"c:\Users\Usuario\Desktop\Practica Angular\14-back\src\presentation\payment\controller.payment.ts", "TypeScript", 512, 24, 84, 620
"c:\Users\Usuario\Desktop\Practica Angular\14-back\src\presentation\payment\routes.payment-method.ts", "TypeScript", 41, 5, 7, 53
"c:\Users\Usuario\Desktop\Practica Angular\14-back\src\presentation\payment\routes.payment.ts", "TypeScript", 43, 8, 9, 60
"c:\Users\Usuario\Desktop\Practica Angular\14-back\src\presentation\products\controller.category.ts", "TypeScript", 75, 14, 33, 122
"c:\Users\Usuario\Desktop\Practica Angular\14-back\src\presentation\products\controller.product.ts", "TypeScript", 257, 7, 18, 282
"c:\Users\Usuario\Desktop\Practica Angular\14-back\src\presentation\products\controller.tag.ts", "TypeScript", 62, 1, 11, 74
"c:\Users\Usuario\Desktop\Practica Angular\14-back\src\presentation\products\controller.unit.ts", "TypeScript", 73, 11, 28, 112
"c:\Users\Usuario\Desktop\Practica Angular\14-back\src\presentation\products\routes.category..ts", "TypeScript", 18, 2, 5, 25
"c:\Users\Usuario\Desktop\Practica Angular\14-back\src\presentation\products\routes.product.ts", "TypeScript", 30, 26, 8, 64
"c:\Users\Usuario\Desktop\Practica Angular\14-back\src\presentation\products\routes.tag.ts", "TypeScript", 15, 4, 6, 25
"c:\Users\Usuario\Desktop\Practica Angular\14-back\src\presentation\products\routes.unit.ts", "TypeScript", 18, 2, 4, 24
"c:\Users\Usuario\Desktop\Practica Angular\14-back\src\presentation\routes.ts", "TypeScript", 79, 7, 13, 99
"c:\Users\Usuario\Desktop\Practica Angular\14-back\src\presentation\sales\controller.ts", "TypeScript", 107, 1, 23, 131
"c:\Users\Usuario\Desktop\Practica Angular\14-back\src\presentation\sales\routes.ts", "TypeScript", 46, 5, 8, 59
"c:\Users\Usuario\Desktop\Practica Angular\14-back\src\presentation\server.ts", "TypeScript", 105, 12, 21, 138
"c:\Users\Usuario\Desktop\Practica Angular\14-back\src\seeders\index.ts", "TypeScript", 33, 4, 8, 45
"c:\Users\Usuario\Desktop\Practica Angular\14-back\src\seeders\order-status.seeder.ts", "TypeScript", 133, 6, 13, 152
"c:\Users\Usuario\Desktop\Practica Angular\14-back\src\seeders\payment-method.seeder.ts", "TypeScript", 99, 6, 15, 120
"Total", "-", 19304, 1822, 3465, 24591