"filename", "language", "TypeScript", "JavaScript", "Markdown", "YAML", "comment", "blank", "total"
"c:\Users\Usuario\Desktop\Practica Angular\14-back\src\app.ts", "TypeScript", -16, 0, 0, 0, -3, -4, -23
"c:\Users\Usuario\Desktop\Practica Angular\14-back\src\configs\bcrypt.ts", "TypeScript", -11, 0, 0, 0, -3, -2, -16
"c:\Users\Usuario\Desktop\Practica Angular\14-back\src\configs\cloudinary.ts", "TypeScript", -8, 0, 0, 0, -1, -2, -11
"c:\Users\Usuario\Desktop\Practica Angular\14-back\src\configs\envs.ts", "TypeScript", -26, 0, 0, 0, -5, -18, -49
"c:\Users\Usuario\Desktop\Practica Angular\14-back\src\configs\file-storage.ts", "TypeScript", -3, 0, 0, 0, -5, -2, -10
"c:\Users\Usuario\Desktop\Practica Angular\14-back\src\configs\jwt-personal.ts", "TypeScript", -26, 0, 0, 0, -7, -8, -41
"c:\Users\Usuario\Desktop\Practica Angular\14-back\src\configs\jwt.ts", "TypeScript", -31, 0, 0, 0, -5, -7, -43
"c:\Users\Usuario\Desktop\Practica Angular\14-back\src\configs\logger.ts", "TypeScript", -118, 0, 0, 0, -22, -23, -163
"c:\Users\Usuario\Desktop\Practica Angular\14-back\src\configs\notification.config.ts", "TypeScript", -34, 0, 0, 0, -2, -6, -42
"c:\Users\Usuario\Desktop\Practica Angular\14-back\src\configs\notification.ts", "TypeScript", -1, 0, 0, 0, -1, -1, -3
"c:\Users\Usuario\Desktop\Practica Angular\14-back\src\configs\payment.ts", "TypeScript", -9, 0, 0, 0, -5, -2, -16
"c:\Users\Usuario\Desktop\Practica Angular\14-back\src\configs\validator.ts", "TypeScript", -5, 0, 0, 0, -1, -4, -10
"c:\Users\Usuario\Desktop\Practica Angular\14-back\src\data\mongodb\models\cart\cart.model.ts", "TypeScript", -59, 0, 0, 0, -6, -5, -70
"c:\Users\Usuario\Desktop\Practica Angular\14-back\src\data\mongodb\models\chatbot\chat-models.ts", "TypeScript", -74, 0, 0, 0, -7, -5, -86
"c:\Users\Usuario\Desktop\Practica Angular\14-back\src\data\mongodb\models\coupon\coupon.model.ts", "TypeScript", -83, 0, 0, 0, -4, -5, -92
"c:\Users\Usuario\Desktop\Practica Angular\14-back\src\data\mongodb\models\customers\address.model.ts", "TypeScript", -67, 0, 0, 0, -5, -4, -76
"c:\Users\Usuario\Desktop\Practica Angular\14-back\src\data\mongodb\models\customers\city.model.ts", "TypeScript", -24, 0, 0, 0, 0, -2, -26
"c:\Users\Usuario\Desktop\Practica Angular\14-back\src\data\mongodb\models\customers\customer.model.ts", "TypeScript", -49, 0, 0, 0, -9, -3, -61
"c:\Users\Usuario\Desktop\Practica Angular\14-back\src\data\mongodb\models\customers\neighborhood.model.ts", "TypeScript", -29, 0, 0, 0, -1, -3, -33
"c:\Users\Usuario\Desktop\Practica Angular\14-back\src\data\mongodb\models\order\order-status.model.ts", "TypeScript", -64, 0, 0, 0, -4, -5, -73
"c:\Users\Usuario\Desktop\Practica Angular\14-back\src\data\mongodb\models\order\order.model.ts", "TypeScript", -35, 0, 0, 0, -3, -6, -44
"c:\Users\Usuario\Desktop\Practica Angular\14-back\src\data\mongodb\models\payment\payment-method.model.ts", "TypeScript", -41, 0, 0, 0, -3, -5, -49
"c:\Users\Usuario\Desktop\Practica Angular\14-back\src\data\mongodb\models\payment\payment.model.ts", "TypeScript", -65, 0, 0, 0, -6, -3, -74
"c:\Users\Usuario\Desktop\Practica Angular\14-back\src\data\mongodb\models\products\category.model.ts", "TypeScript", -20, 0, 0, 0, 0, -6, -26
"c:\Users\Usuario\Desktop\Practica Angular\14-back\src\data\mongodb\models\products\product.model.ts", "TypeScript", -73, 0, 0, 0, -8, -5, -86
"c:\Users\Usuario\Desktop\Practica Angular\14-back\src\data\mongodb\models\products\tag.model.ts", "TypeScript", -27, 0, 0, 0, -1, -3, -31
"c:\Users\Usuario\Desktop\Practica Angular\14-back\src\data\mongodb\models\products\unit.model.ts", "TypeScript", -21, 0, 0, 0, 0, -3, -24
"c:\Users\Usuario\Desktop\Practica Angular\14-back\src\data\mongodb\models\sales\sale.model.ts", "TypeScript", -82, 0, 0, 0, -1, -4, -87
"c:\Users\Usuario\Desktop\Practica Angular\14-back\src\data\mongodb\models\user.model.ts", "TypeScript", -33, 0, 0, 0, -3, -7, -43
"c:\Users\Usuario\Desktop\Practica Angular\14-back\src\data\mongodb\mongo-database.ts", "TypeScript", -25, 0, 0, 0, 0, -9, -34
"c:\Users\Usuario\Desktop\Practica Angular\14-back\src\domain\datasources\auth.datasource.ts", "TypeScript", -12, 0, 0, 0, -10, -4, -26
"c:\Users\Usuario\Desktop\Practica Angular\14-back\src\domain\datasources\cart\cart.datasource.ts", "TypeScript", -11, 0, 0, 0, -5, -8, -24
"c:\Users\Usuario\Desktop\Practica Angular\14-back\src\domain\datasources\chatbot\chat.datasource.ts", "TypeScript", -11, 0, 0, 0, -1, -1, -13
"c:\Users\Usuario\Desktop\Practica Angular\14-back\src\domain\datasources\coupon\coupon.datasource.ts", "TypeScript", -13, 0, 0, 0, -3, -3, -19
"c:\Users\Usuario\Desktop\Practica Angular\14-back\src\domain\datasources\customers\city.datasource.ts", "TypeScript", -13, 0, 0, 0, 0, -1, -14
"c:\Users\Usuario\Desktop\Practica Angular\14-back\src\domain\datasources\customers\customer.datasource.ts", "TypeScript", -23, 0, 0, 0, -4, -2, -29
"c:\Users\Usuario\Desktop\Practica Angular\14-back\src\domain\datasources\customers\neighborhood.datasource.ts", "TypeScript", -14, 0, 0, 0, 0, -1, -15
"c:\Users\Usuario\Desktop\Practica Angular\14-back\src\domain\datasources\mcp\mcp.datasource.ts", "TypeScript", -5, 0, 0, 0, -1, -2, -8
"c:\Users\Usuario\Desktop\Practica Angular\14-back\src\domain\datasources\order\order-status.datasource.ts", "TypeScript", -14, 0, 0, 0, -1, -2, -17
"c:\Users\Usuario\Desktop\Practica Angular\14-back\src\domain\datasources\order\order.datasource.ts", "TypeScript", -31, 0, 0, 0, -9, -9, -49
"c:\Users\Usuario\Desktop\Practica Angular\14-back\src\domain\datasources\payment\payment-method.datasource.ts", "TypeScript", -13, 0, 0, 0, -1, -3, -17
"c:\Users\Usuario\Desktop\Practica Angular\14-back\src\domain\datasources\payment\payment.datasource.ts", "TypeScript", -22, 0, 0, 0, -13, -13, -48
"c:\Users\Usuario\Desktop\Practica Angular\14-back\src\domain\datasources\products\category.datasource.ts", "TypeScript", -13, 0, 0, 0, 0, -6, -19
"c:\Users\Usuario\Desktop\Practica Angular\14-back\src\domain\datasources\products\product.datasource.ts", "TypeScript", -17, 0, 0, 0, -1, -1, -19
"c:\Users\Usuario\Desktop\Practica Angular\14-back\src\domain\datasources\products\tag.datasource.ts", "TypeScript", -12, 0, 0, 0, -1, -1, -14
"c:\Users\Usuario\Desktop\Practica Angular\14-back\src\domain\datasources\products\unit.datasource.ts", "TypeScript", -13, 0, 0, 0, 0, -4, -17
"c:\Users\Usuario\Desktop\Practica Angular\14-back\src\domain\datasources\sales\sale.datasource.ts", "TypeScript", -13, 0, 0, 0, -1, -2, -16
"c:\Users\Usuario\Desktop\Practica Angular\14-back\src\domain\dtos\auth\forgot-password.dto.ts", "TypeScript", -12, 0, 0, 0, -1, -5, -18
"c:\Users\Usuario\Desktop\Practica Angular\14-back\src\domain\dtos\auth\login-user.dto.ts", "TypeScript", -14, 0, 0, 0, -1, -10, -25
"c:\Users\Usuario\Desktop\Practica Angular\14-back\src\domain\dtos\auth\register-user.dto.ts", "TypeScript", -17, 0, 0, 0, -12, -13, -42
"c:\Users\Usuario\Desktop\Practica Angular\14-back\src\domain\dtos\auth\reset-password.dto.ts", "TypeScript", -16, 0, 0, 0, -1, -5, -22
"c:\Users\Usuario\Desktop\Practica Angular\14-back\src\domain\dtos\cart\add-item-to-cart.dto.ts", "TypeScript", -18, 0, 0, 0, -1, -5, -24
"c:\Users\Usuario\Desktop\Practica Angular\14-back\src\domain\dtos\cart\update-cart-item.dto.ts", "TypeScript", -18, 0, 0, 0, -2, -5, -25
"c:\Users\Usuario\Desktop\Practica Angular\14-back\src\domain\dtos\chatbot\chat-query.dto.ts", "TypeScript", -24, 0, 0, 0, -3, -5, -32
"c:\Users\Usuario\Desktop\Practica Angular\14-back\src\domain\dtos\coupon\create-coupon.dto.ts", "TypeScript", -69, 0, 0, 0, -2, -12, -83
"c:\Users\Usuario\Desktop\Practica Angular\14-back\src\domain\dtos\coupon\update-coupon.dto.ts", "TypeScript", -105, 0, 0, 0, -5, -15, -125
"c:\Users\Usuario\Desktop\Practica Angular\14-back\src\domain\dtos\customers\create-address.dto.ts", "TypeScript", -57, 0, 0, 0, -5, -6, -68
"c:\Users\Usuario\Desktop\Practica Angular\14-back\src\domain\dtos\customers\create-city.dto.ts", "TypeScript", -24, 0, 0, 0, -4, -5, -33
"c:\Users\Usuario\Desktop\Practica Angular\14-back\src\domain\dtos\customers\create-customer.dto.ts", "TypeScript", -47, 0, 0, 0, -7, -10, -64
"c:\Users\Usuario\Desktop\Practica Angular\14-back\src\domain\dtos\customers\create-neighborhood.dto.ts", "TypeScript", -30, 0, 0, 0, -5, -7, -42
"c:\Users\Usuario\Desktop\Practica Angular\14-back\src\domain\dtos\customers\update-address.dto.ts", "TypeScript", -71, 0, 0, 0, -4, -9, -84
"c:\Users\Usuario\Desktop\Practica Angular\14-back\src\domain\dtos\customers\update-city.dto.ts", "TypeScript", -37, 0, 0, 0, -3, -6, -46
"c:\Users\Usuario\Desktop\Practica Angular\14-back\src\domain\dtos\customers\update-customer.dto.ts", "TypeScript", -66, 0, 0, 0, -3, -11, -80
"c:\Users\Usuario\Desktop\Practica Angular\14-back\src\domain\dtos\customers\update-neighborhood.dto.ts", "TypeScript", -45, 0, 0, 0, -3, -7, -55
"c:\Users\Usuario\Desktop\Practica Angular\14-back\src\domain\dtos\mcp\mcp-call.dto.ts", "TypeScript", -29, 0, 0, 0, -2, -7, -38
"c:\Users\Usuario\Desktop\Practica Angular\14-back\src\domain\dtos\order\create-order-status.dto.ts", "TypeScript", -56, 0, 0, 0, -4, -8, -68
"c:\Users\Usuario\Desktop\Practica Angular\14-back\src\domain\dtos\order\create-order.dto.ts", "TypeScript", -108, 0, 0, 0, -12, -15, -135
"c:\Users\Usuario\Desktop\Practica Angular\14-back\src\domain\dtos\order\select-payment-method.dto.ts", "TypeScript", -27, 0, 0, 0, -4, -8, -39
"c:\Users\Usuario\Desktop\Practica Angular\14-back\src\domain\dtos\order\update-order-status-data.dto.ts", "TypeScript", -76, 0, 0, 0, -6, -12, -94
"c:\Users\Usuario\Desktop\Practica Angular\14-back\src\domain\dtos\order\update-order-status-transitions.dto.ts", "TypeScript", -24, 0, 0, 0, -1, -9, -34
"c:\Users\Usuario\Desktop\Practica Angular\14-back\src\domain\dtos\order\update-order-status.dto.ts", "TypeScript", -32, 0, 0, 0, -2, -7, -41
"c:\Users\Usuario\Desktop\Practica Angular\14-back\src\domain\dtos\order\update-order.dto.ts", "TypeScript", -29, 0, 0, 0, -1, -3, -33
"c:\Users\Usuario\Desktop\Practica Angular\14-back\src\domain\dtos\payment\create-payment-method.dto.ts", "TypeScript", -38, 0, 0, 0, -1, -5, -44
"c:\Users\Usuario\Desktop\Practica Angular\14-back\src\domain\dtos\payment\create-payment.dto.ts", "TypeScript", -74, 0, 0, 0, -4, -9, -87
"c:\Users\Usuario\Desktop\Practica Angular\14-back\src\domain\dtos\payment\process-webhook.dto.ts", "TypeScript", -24, 0, 0, 0, -1, -3, -28
"c:\Users\Usuario\Desktop\Practica Angular\14-back\src\domain\dtos\payment\update-payment-method.dto.ts", "TypeScript", -31, 0, 0, 0, -1, -4, -36
"c:\Users\Usuario\Desktop\Practica Angular\14-back\src\domain\dtos\payment\update-payment-status.dto.ts", "TypeScript", -27, 0, 0, 0, -1, -4, -32
"c:\Users\Usuario\Desktop\Practica Angular\14-back\src\domain\dtos\payment\verify-payment.dto.ts", "TypeScript", -18, 0, 0, 0, -1, -3, -22
"c:\Users\Usuario\Desktop\Practica Angular\14-back\src\domain\dtos\products\create-category.ts", "TypeScript", -15, 0, 0, 0, -7, -7, -29
"c:\Users\Usuario\Desktop\Practica Angular\14-back\src\domain\dtos\products\create-product.dto.ts", "TypeScript", -57, 0, 0, 0, -9, -10, -76
"c:\Users\Usuario\Desktop\Practica Angular\14-back\src\domain\dtos\products\create-tag.dto.ts", "TypeScript", -19, 0, 0, 0, -1, -4, -24
"c:\Users\Usuario\Desktop\Practica Angular\14-back\src\domain\dtos\products\create-unit.dto.ts", "TypeScript", -15, 0, 0, 0, -6, -9, -30
"c:\Users\Usuario\Desktop\Practica Angular\14-back\src\domain\dtos\products\search-product.dto.ts", "TypeScript", -99, 0, 0, 0, -10, -14, -123
"c:\Users\Usuario\Desktop\Practica Angular\14-back\src\domain\dtos\products\udpate-unit.dto.ts", "TypeScript", -34, 0, 0, 0, -7, -10, -51
"c:\Users\Usuario\Desktop\Practica Angular\14-back\src\domain\dtos\products\update-category.dto.ts", "TypeScript", -28, 0, 0, 0, -4, -9, -41
"c:\Users\Usuario\Desktop\Practica Angular\14-back\src\domain\dtos\products\update-product.dto.ts", "TypeScript", -97, 0, 0, 0, -15, -13, -125
"c:\Users\Usuario\Desktop\Practica Angular\14-back\src\domain\dtos\products\update-tag.dto.ts", "TypeScript", -31, 0, 0, 0, -1, -7, -39
"c:\Users\Usuario\Desktop\Practica Angular\14-back\src\domain\dtos\sales\create-sale.dto.ts", "TypeScript", -56, 0, 0, 0, -5, -10, -71
"c:\Users\Usuario\Desktop\Practica Angular\14-back\src\domain\dtos\sales\update-sale-status.dto.ts", "TypeScript", -20, 0, 0, 0, -1, -4, -25
"c:\Users\Usuario\Desktop\Practica Angular\14-back\src\domain\dtos\shared\pagination.dto.ts", "TypeScript", -16, 0, 0, 0, -6, -8, -30
"c:\Users\Usuario\Desktop\Practica Angular\14-back\src\domain\entities\cart\cart-item.entity.ts", "TypeScript", -14, 0, 0, 0, -10, -4, -28
"c:\Users\Usuario\Desktop\Practica Angular\14-back\src\domain\entities\cart\cart.entity.ts", "TypeScript", -16, 0, 0, 0, -18, -6, -40
"c:\Users\Usuario\Desktop\Practica Angular\14-back\src\domain\entities\chatbot\chat-message.entity.ts", "TypeScript", -24, 0, 0, 0, -1, -2, -27
"c:\Users\Usuario\Desktop\Practica Angular\14-back\src\domain\entities\coupon\coupon.entity.ts", "TypeScript", -32, 0, 0, 0, -3, -3, -38
"c:\Users\Usuario\Desktop\Practica Angular\14-back\src\domain\entities\customers\address.entity.ts", "TypeScript", -26, 0, 0, 0, -2, -2, -30
"c:\Users\Usuario\Desktop\Practica Angular\14-back\src\domain\entities\customers\citiy.ts", "TypeScript", -8, 0, 0, 0, -1, 0, -9
"c:\Users\Usuario\Desktop\Practica Angular\14-back\src\domain\entities\customers\customer.ts", "TypeScript", -13, 0, 0, 0, -1, -2, -16
"c:\Users\Usuario\Desktop\Practica Angular\14-back\src\domain\entities\customers\neighborhood.ts", "TypeScript", -10, 0, 0, 0, -1, -3, -14
"c:\Users\Usuario\Desktop\Practica Angular\14-back\src\domain\entities\mcp\mcp.entity.ts", "TypeScript", -21, 0, 0, 0, -1, -4, -26
"c:\Users\Usuario\Desktop\Practica Angular\14-back\src\domain\entities\monitoring\cloudinary-usage.entity.ts", "TypeScript", -120, 0, 0, 0, -4, -17, -141
"c:\Users\Usuario\Desktop\Practica Angular\14-back\src\domain\entities\monitoring\mongodb-usage.entity.ts", "TypeScript", -55, 0, 0, 0, 0, -8, -63
"c:\Users\Usuario\Desktop\Practica Angular\14-back\src\domain\entities\monitoring\render-usage.entity.ts", "TypeScript", -83, 0, 0, 0, 0, -9, -92
"c:\Users\Usuario\Desktop\Practica Angular\14-back\src\domain\entities\order\order-status.entity.ts", "TypeScript", -18, 0, 0, 0, -1, -2, -21
"c:\Users\Usuario\Desktop\Practica Angular\14-back\src\domain\entities\order\order.entity.ts", "TypeScript", -43, 0, 0, 0, -9, -5, -57
"c:\Users\Usuario\Desktop\Practica Angular\14-back\src\domain\entities\payment\payment-method.entity.ts", "TypeScript", -50, 0, 0, 0, -2, -7, -59
"c:\Users\Usuario\Desktop\Practica Angular\14-back\src\domain\entities\payment\payment.entity.ts", "TypeScript", -34, 0, 0, 0, -2, -4, -40
"c:\Users\Usuario\Desktop\Practica Angular\14-back\src\domain\entities\products\category.entity.ts", "TypeScript", -8, 0, 0, 0, 0, -1, -9
"c:\Users\Usuario\Desktop\Practica Angular\14-back\src\domain\entities\products\product.entity.ts", "TypeScript", -18, 0, 0, 0, -1, -4, -23
"c:\Users\Usuario\Desktop\Practica Angular\14-back\src\domain\entities\products\tag.entity.ts", "TypeScript", -10, 0, 0, 0, -1, 0, -11
"c:\Users\Usuario\Desktop\Practica Angular\14-back\src\domain\entities\products\unit.entity.ts", "TypeScript", -8, 0, 0, 0, 0, -2, -10
"c:\Users\Usuario\Desktop\Practica Angular\14-back\src\domain\entities\sales\sale.entity.ts", "TypeScript", -24, 0, 0, 0, -1, -3, -28
"c:\Users\Usuario\Desktop\Practica Angular\14-back\src\domain\entities\user.entity.ts", "TypeScript", -10, 0, 0, 0, -3, -4, -17
"c:\Users\Usuario\Desktop\Practica Angular\14-back\src\domain\errors\custom.error.ts", "TypeScript", -27, 0, 0, 0, 0, -8, -35
"c:\Users\Usuario\Desktop\Practica Angular\14-back\src\domain\interfaces\email.service.ts", "TypeScript", -25, 0, 0, 0, -2, -5, -32
"c:\Users\Usuario\Desktop\Practica Angular\14-back\src\domain\interfaces\file-storage.interface.ts", "TypeScript", -9, 0, 0, 0, -17, -5, -31
"c:\Users\Usuario\Desktop\Practica Angular\14-back\src\domain\interfaces\logger.interface.ts", "TypeScript", -7, 0, 0, 0, -16, -6, -29
"c:\Users\Usuario\Desktop\Practica Angular\14-back\src\domain\interfaces\notification.interface.ts", "TypeScript", -11, 0, 0, 0, -1, -3, -15
"c:\Users\Usuario\Desktop\Practica Angular\14-back\src\domain\interfaces\payment.service.ts", "TypeScript", -112, 0, 0, 0, -1, -11, -124
"c:\Users\Usuario\Desktop\Practica Angular\14-back\src\domain\interfaces\payment\mercado-pago.interface.ts", "TypeScript", -146, 0, 0, 0, -10, -6, -162
"c:\Users\Usuario\Desktop\Practica Angular\14-back\src\domain\interfaces\services\logger.service.ts", "TypeScript", -7, 0, 0, 0, -1, -1, -9
"c:\Users\Usuario\Desktop\Practica Angular\14-back\src\domain\interfaces\services\notification.service.ts", "TypeScript", -16, 0, 0, 0, -1, -1, -18
"c:\Users\Usuario\Desktop\Practica Angular\14-back\src\domain\interfaces\telegram.service.ts", "TypeScript", -17, 0, 0, 0, -1, -4, -22
"c:\Users\Usuario\Desktop\Practica Angular\14-back\src\domain\repositories\auth.repository.ts", "TypeScript", -12, 0, 0, 0, -3, -5, -20
"c:\Users\Usuario\Desktop\Practica Angular\14-back\src\domain\repositories\cart\cart.repository.ts", "TypeScript", -10, 0, 0, 0, -2, -6, -18
"c:\Users\Usuario\Desktop\Practica Angular\14-back\src\domain\repositories\chatbot\chat.repository.ts", "TypeScript", -11, 0, 0, 0, -1, -1, -13
"c:\Users\Usuario\Desktop\Practica Angular\14-back\src\domain\repositories\coupon\coupon.repository.ts", "TypeScript", -13, 0, 0, 0, -2, -3, -18
"c:\Users\Usuario\Desktop\Practica Angular\14-back\src\domain\repositories\customers\city.repository.ts", "TypeScript", -13, 0, 0, 0, 0, -1, -14
"c:\Users\Usuario\Desktop\Practica Angular\14-back\src\domain\repositories\customers\customer.repository.ts", "TypeScript", -23, 0, 0, 0, -4, -2, -29
"c:\Users\Usuario\Desktop\Practica Angular\14-back\src\domain\repositories\customers\neighborhood.repository.ts", "TypeScript", -14, 0, 0, 0, 0, -1, -15
"c:\Users\Usuario\Desktop\Practica Angular\14-back\src\domain\repositories\mcp\mcp.repository.ts", "TypeScript", -5, 0, 0, 0, -1, -2, -8
"c:\Users\Usuario\Desktop\Practica Angular\14-back\src\domain\repositories\order\order-status.repository.ts", "TypeScript", -14, 0, 0, 0, -1, -2, -17
"c:\Users\Usuario\Desktop\Practica Angular\14-back\src\domain\repositories\order\order.repository.ts", "TypeScript", -32, 0, 0, 0, -9, -8, -49
"c:\Users\Usuario\Desktop\Practica Angular\14-back\src\domain\repositories\payment\payment-method.repository.ts", "TypeScript", -13, 0, 0, 0, -1, -3, -17
"c:\Users\Usuario\Desktop\Practica Angular\14-back\src\domain\repositories\payment\payment.repository.ts", "TypeScript", -22, 0, 0, 0, -14, -15, -51
"c:\Users\Usuario\Desktop\Practica Angular\14-back\src\domain\repositories\products\categroy.repository.ts", "TypeScript", -13, 0, 0, 0, 0, -4, -17
"c:\Users\Usuario\Desktop\Practica Angular\14-back\src\domain\repositories\products\product.repository.ts", "TypeScript", -17, 0, 0, 0, -1, -1, -19
"c:\Users\Usuario\Desktop\Practica Angular\14-back\src\domain\repositories\products\tag.repository.ts", "TypeScript", -12, 0, 0, 0, -1, -1, -14
"c:\Users\Usuario\Desktop\Practica Angular\14-back\src\domain\repositories\products\unit.repository.ts", "TypeScript", -13, 0, 0, 0, 0, -2, -15
"c:\Users\Usuario\Desktop\Practica Angular\14-back\src\domain\repositories\sales\sale.repository.ts", "TypeScript", -13, 0, 0, 0, -1, -1, -15
"c:\Users\Usuario\Desktop\Practica Angular\14-back\src\domain\use-cases\auth\login-user.use-case.ts", "TypeScript", -47, 0, 0, 0, -10, -25, -82
"c:\Users\Usuario\Desktop\Practica Angular\14-back\src\domain\use-cases\auth\register-user.use-case.ts", "TypeScript", -88, 0, 0, 0, -34, -17, -139
"c:\Users\Usuario\Desktop\Practica Angular\14-back\src\domain\use-cases\auth\request-password-reset.use-case.ts", "TypeScript", -42, 0, 0, 0, -10, -13, -65
"c:\Users\Usuario\Desktop\Practica Angular\14-back\src\domain\use-cases\auth\reset-password.use-case.ts", "TypeScript", -44, 0, 0, 0, -9, -14, -67
"c:\Users\Usuario\Desktop\Practica Angular\14-back\src\domain\use-cases\cart\add-to-cart.use-case.ts", "TypeScript", -40, 0, 0, 0, -13, -8, -61
"c:\Users\Usuario\Desktop\Practica Angular\14-back\src\domain\use-cases\cart\clear-cart.use-case.ts", "TypeScript", -19, 0, 0, 0, 0, -4, -23
"c:\Users\Usuario\Desktop\Practica Angular\14-back\src\domain\use-cases\cart\get-cart.use-case.ts", "TypeScript", -19, 0, 0, 0, -1, -4, -24
"c:\Users\Usuario\Desktop\Practica Angular\14-back\src\domain\use-cases\cart\remove-from-cart.use-case.ts", "TypeScript", -22, 0, 0, 0, 0, -5, -27
"c:\Users\Usuario\Desktop\Practica Angular\14-back\src\domain\use-cases\cart\update-cart-item.use-case.ts", "TypeScript", -58, 0, 0, 0, -18, -10, -86
"c:\Users\Usuario\Desktop\Practica Angular\14-back\src\domain\use-cases\chatbot\generate-embeddings.use-case.ts", "TypeScript", -18, 0, 0, 0, -1, -2, -21
"c:\Users\Usuario\Desktop\Practica Angular\14-back\src\domain\use-cases\chatbot\query-chatbot.use-case.ts", "TypeScript", -45, 0, 0, 0, -6, -8, -59
"c:\Users\Usuario\Desktop\Practica Angular\14-back\src\domain\use-cases\coupon\create-coupon.use-case.ts", "TypeScript", -23, 0, 0, 0, -3, -4, -30
"c:\Users\Usuario\Desktop\Practica Angular\14-back\src\domain\use-cases\coupon\delete-coupon.use-case.ts", "TypeScript", -21, 0, 0, 0, -3, -3, -27
"c:\Users\Usuario\Desktop\Practica Angular\14-back\src\domain\use-cases\coupon\get-all-coupons.use-case.ts", "TypeScript", -19, 0, 0, 0, -1, -3, -23
"c:\Users\Usuario\Desktop\Practica Angular\14-back\src\domain\use-cases\coupon\get-coupon-by-id.use-case.ts", "TypeScript", -21, 0, 0, 0, -1, -3, -25
"c:\Users\Usuario\Desktop\Practica Angular\14-back\src\domain\use-cases\coupon\update-coupon.use-case.ts", "TypeScript", -39, 0, 0, 0, -5, -7, -51
"c:\Users\Usuario\Desktop\Practica Angular\14-back\src\domain\use-cases\customers\create-address.use-case.ts", "TypeScript", -44, 0, 0, 0, -6, -6, -56
"c:\Users\Usuario\Desktop\Practica Angular\14-back\src\domain\use-cases\customers\create-city.use-case.ts", "TypeScript", -33, 0, 0, 0, -4, -8, -45
"c:\Users\Usuario\Desktop\Practica Angular\14-back\src\domain\use-cases\customers\create-customer.use-case.ts", "TypeScript", -32, 0, 0, 0, -4, -6, -42
"c:\Users\Usuario\Desktop\Practica Angular\14-back\src\domain\use-cases\customers\create-neighborhood.use-case.ts", "TypeScript", -39, 0, 0, 0, -4, -8, -51
"c:\Users\Usuario\Desktop\Practica Angular\14-back\src\domain\use-cases\customers\delete-address.use-case.ts", "TypeScript", -29, 0, 0, 0, -6, -4, -39
"c:\Users\Usuario\Desktop\Practica Angular\14-back\src\domain\use-cases\customers\delete-city.use-case.ts", "TypeScript", -26, 0, 0, 0, -3, -6, -35
"c:\Users\Usuario\Desktop\Practica Angular\14-back\src\domain\use-cases\customers\delete-customer.use-case.ts", "TypeScript", -26, 0, 0, 0, -3, -6, -35
"c:\Users\Usuario\Desktop\Practica Angular\14-back\src\domain\use-cases\customers\delete-neighborhood.use-case.ts", "TypeScript", -26, 0, 0, 0, -3, -6, -35
"c:\Users\Usuario\Desktop\Practica Angular\14-back\src\domain\use-cases\customers\find-city-by-name.use-case.ts", "TypeScript", -28, 0, 0, 0, -3, -6, -37
"c:\Users\Usuario\Desktop\Practica Angular\14-back\src\domain\use-cases\customers\find-customers-by-neighborhood.use-case.ts", "TypeScript", -31, 0, 0, 0, -3, -6, -40
"c:\Users\Usuario\Desktop\Practica Angular\14-back\src\domain\use-cases\customers\find-neighborhoods-by-city.use-case.ts", "TypeScript", -31, 0, 0, 0, -3, -6, -40
"c:\Users\Usuario\Desktop\Practica Angular\14-back\src\domain\use-cases\customers\get-all-cities.use-case.ts", "TypeScript", -28, 0, 0, 0, -3, -5, -36
"c:\Users\Usuario\Desktop\Practica Angular\14-back\src\domain\use-cases\customers\get-all-customers.use-case.ts", "TypeScript", -28, 0, 0, 0, -3, -5, -36
"c:\Users\Usuario\Desktop\Practica Angular\14-back\src\domain\use-cases\customers\get-all-neighborhoods.use-case.ts", "TypeScript", -28, 0, 0, 0, -3, -5, -36
"c:\Users\Usuario\Desktop\Practica Angular\14-back\src\domain\use-cases\customers\get-city-by-id..use-case.ts", "TypeScript", -25, 0, 0, 0, -2, -5, -32
"c:\Users\Usuario\Desktop\Practica Angular\14-back\src\domain\use-cases\customers\get-customer-by-email.use-case.ts", "TypeScript", -26, 0, 0, 0, -3, -5, -34
"c:\Users\Usuario\Desktop\Practica Angular\14-back\src\domain\use-cases\customers\get-customer-by-id.use-case.ts", "TypeScript", -25, 0, 0, 0, -2, -5, -32
"c:\Users\Usuario\Desktop\Practica Angular\14-back\src\domain\use-cases\customers\get-my-addresses.use-case.ts", "TypeScript", -29, 0, 0, 0, -7, -5, -41
"c:\Users\Usuario\Desktop\Practica Angular\14-back\src\domain\use-cases\customers\get-neighborhood-by-id.use-case.ts", "TypeScript", -25, 0, 0, 0, -2, -5, -32
"c:\Users\Usuario\Desktop\Practica Angular\14-back\src\domain\use-cases\customers\set-default-address.use-case.ts", "TypeScript", -39, 0, 0, 0, -7, -7, -53
"c:\Users\Usuario\Desktop\Practica Angular\14-back\src\domain\use-cases\customers\update-address.use-case.ts", "TypeScript", -54, 0, 0, 0, -9, -7, -70
"c:\Users\Usuario\Desktop\Practica Angular\14-back\src\domain\use-cases\customers\update-city.use-case.ts", "TypeScript", -27, 0, 0, 0, -2, -4, -33
"c:\Users\Usuario\Desktop\Practica Angular\14-back\src\domain\use-cases\customers\update-customer.use-case.ts", "TypeScript", -38, 0, 0, 0, -4, -6, -48
"c:\Users\Usuario\Desktop\Practica Angular\14-back\src\domain\use-cases\customers\update-neighborhood.use-case.ts", "TypeScript", -32, 0, 0, 0, -3, -5, -40
"c:\Users\Usuario\Desktop\Practica Angular\14-back\src\domain\use-cases\mcp\call-tool.use-case.ts", "TypeScript", -22, 0, 0, 0, -1, -3, -26
"c:\Users\Usuario\Desktop\Practica Angular\14-back\src\domain\use-cases\mcp\list-tools.use-case.ts", "TypeScript", -10, 0, 0, 0, -1, -3, -14
"c:\Users\Usuario\Desktop\Practica Angular\14-back\src\domain\use-cases\monitoring\monitor-cloudinary-usage.use-case.ts", "TypeScript", -240, 0, 0, 0, -21, -38, -299
"c:\Users\Usuario\Desktop\Practica Angular\14-back\src\domain\use-cases\monitoring\monitor-mongodb-usage.use-case.ts", "TypeScript", -141, 0, 0, 0, -16, -23, -180
"c:\Users\Usuario\Desktop\Practica Angular\14-back\src\domain\use-cases\monitoring\monitor-render-usage.use-case.ts", "TypeScript", -165, 0, 0, 0, -14, -36, -215
"c:\Users\Usuario\Desktop\Practica Angular\14-back\src\domain\use-cases\notification\notify-order.use-case.ts", "TypeScript", -69, 0, 0, 0, -3, -7, -79
"c:\Users\Usuario\Desktop\Practica Angular\14-back\src\domain\use-cases\notifications\notify-order.use-case.ts", "TypeScript", -66, 0, 0, 0, -3, -6, -75
"c:\Users\Usuario\Desktop\Practica Angular\14-back\src\domain\use-cases\order\create-order-status.use-case.ts", "TypeScript", -28, 0, 0, 0, -2, -7, -37
"c:\Users\Usuario\Desktop\Practica Angular\14-back\src\domain\use-cases\order\create-order.use-case.ts", "TypeScript", -176, 0, 0, 0, -11, -20, -207
"c:\Users\Usuario\Desktop\Practica Angular\14-back\src\domain\use-cases\order\delete-order-status.use-case.ts", "TypeScript", -30, 0, 0, 0, -3, -8, -41
"c:\Users\Usuario\Desktop\Practica Angular\14-back\src\domain\use-cases\order\find-order-by-customer.use-case.ts", "TypeScript", -28, 0, 0, 0, -8, -7, -43
"c:\Users\Usuario\Desktop\Practica Angular\14-back\src\domain\use-cases\order\find-order-by-date-range.use-case.ts", "TypeScript", -28, 0, 0, 0, -8, -7, -43
"c:\Users\Usuario\Desktop\Practica Angular\14-back\src\domain\use-cases\order\get-all-order-statuses.use-case.ts", "TypeScript", -24, 0, 0, 0, -1, -6, -31
"c:\Users\Usuario\Desktop\Practica Angular\14-back\src\domain\use-cases\order\get-all-order.use-case.ts", "TypeScript", -25, 0, 0, 0, -8, -5, -38
"c:\Users\Usuario\Desktop\Practica Angular\14-back\src\domain\use-cases\order\get-my-orders.use-case.ts", "TypeScript", -36, 0, 0, 0, -8, -9, -53
"c:\Users\Usuario\Desktop\Practica Angular\14-back\src\domain\use-cases\order\get-order-by-id.use-case.ts", "TypeScript", -25, 0, 0, 0, -2, -5, -32
"c:\Users\Usuario\Desktop\Practica Angular\14-back\src\domain\use-cases\order\get-orders-for-dashboard.use-case.ts", "TypeScript", -52, 0, 0, 0, -18, -17, -87
"c:\Users\Usuario\Desktop\Practica Angular\14-back\src\domain\use-cases\order\select-payment-method.use-case.ts", "TypeScript", -85, 0, 0, 0, -14, -20, -119
"c:\Users\Usuario\Desktop\Practica Angular\14-back\src\domain\use-cases\order\update-order-status-data.use-case.ts", "TypeScript", -59, 0, 0, 0, -7, -9, -75
"c:\Users\Usuario\Desktop\Practica Angular\14-back\src\domain\use-cases\order\update-order-status-transitions.use-case.ts", "TypeScript", -59, 0, 0, 0, -8, -10, -77
"c:\Users\Usuario\Desktop\Practica Angular\14-back\src\domain\use-cases\order\update-order-status.use-case.ts", "TypeScript", -53, 0, 0, 0, -4, -10, -67
"c:\Users\Usuario\Desktop\Practica Angular\14-back\src\domain\use-cases\order\update-order.use-case.ts", "TypeScript", -9, 0, 0, 0, 0, -2, -11
"c:\Users\Usuario\Desktop\Practica Angular\14-back\src\domain\use-cases\order\validate-order-status-transition.use-case.ts", "TypeScript", -36, 0, 0, 0, -3, -9, -48
"c:\Users\Usuario\Desktop\Practica Angular\14-back\src\domain\use-cases\payment\create-payment-method.use-case.ts", "TypeScript", -14, 0, 0, 0, -1, -6, -21
"c:\Users\Usuario\Desktop\Practica Angular\14-back\src\domain\use-cases\payment\create-payment.use-case.ts", "TypeScript", -68, 0, 0, 0, -8, -11, -87
"c:\Users\Usuario\Desktop\Practica Angular\14-back\src\domain\use-cases\payment\delete-payment-method.use-case.ts", "TypeScript", -13, 0, 0, 0, -1, -6, -20
"c:\Users\Usuario\Desktop\Practica Angular\14-back\src\domain\use-cases\payment\get-active-payment-methods.use-case.ts", "TypeScript", -13, 0, 0, 0, -1, -6, -20
"c:\Users\Usuario\Desktop\Practica Angular\14-back\src\domain\use-cases\payment\get-all-payments.use-case.ts", "TypeScript", -21, 0, 0, 0, 0, -3, -24
"c:\Users\Usuario\Desktop\Practica Angular\14-back\src\domain\use-cases\payment\get-payment-by-order.use-case.ts", "TypeScript", -29, 0, 0, 0, -2, -5, -36
"c:\Users\Usuario\Desktop\Practica Angular\14-back\src\domain\use-cases\payment\get-payment-method-by-code.use-case.ts", "TypeScript", -13, 0, 0, 0, -1, -6, -20
"c:\Users\Usuario\Desktop\Practica Angular\14-back\src\domain\use-cases\payment\get-payment-method-by-id.use-case.ts", "TypeScript", -13, 0, 0, 0, -1, -6, -20
"c:\Users\Usuario\Desktop\Practica Angular\14-back\src\domain\use-cases\payment\get-payment-methods.use-case.ts", "TypeScript", -14, 0, 0, 0, -1, -6, -21
"c:\Users\Usuario\Desktop\Practica Angular\14-back\src\domain\use-cases\payment\get-payment.use-case.ts", "TypeScript", -20, 0, 0, 0, 0, -3, -23
"c:\Users\Usuario\Desktop\Practica Angular\14-back\src\domain\use-cases\payment\process-webhook.use-case.ts", "TypeScript", -32, 0, 0, 0, -2, -5, -39
"c:\Users\Usuario\Desktop\Practica Angular\14-back\src\domain\use-cases\payment\update-payment-method.use-case.ts", "TypeScript", -14, 0, 0, 0, -1, -6, -21
"c:\Users\Usuario\Desktop\Practica Angular\14-back\src\domain\use-cases\payment\verify-payment.use-case.ts", "TypeScript", -62, 0, 0, 0, -6, -10, -78
"c:\Users\Usuario\Desktop\Practica Angular\14-back\src\domain\use-cases\product\create-category.use-case.ts", "TypeScript", -33, 0, 0, 0, -4, -15, -52
"c:\Users\Usuario\Desktop\Practica Angular\14-back\src\domain\use-cases\product\create-product.use-case.ts", "TypeScript", -41, 0, 0, 0, -6, -17, -64
"c:\Users\Usuario\Desktop\Practica Angular\14-back\src\domain\use-cases\product\create-unit.use-case.ts", "TypeScript", -31, 0, 0, 0, -5, -13, -49
"c:\Users\Usuario\Desktop\Practica Angular\14-back\src\domain\use-cases\product\delete-category.use-case.ts", "TypeScript", -26, 0, 0, 0, -3, -9, -38
"c:\Users\Usuario\Desktop\Practica Angular\14-back\src\domain\use-cases\product\delete-product.use-case.ts", "TypeScript", -24, 0, 0, 0, -5, -10, -39
"c:\Users\Usuario\Desktop\Practica Angular\14-back\src\domain\use-cases\product\delete-unit.use-case.ts", "TypeScript", -26, 0, 0, 0, -4, -10, -40
"c:\Users\Usuario\Desktop\Practica Angular\14-back\src\domain\use-cases\product\get-all-category.use-case.ts", "TypeScript", -28, 0, 0, 0, -3, -9, -40
"c:\Users\Usuario\Desktop\Practica Angular\14-back\src\domain\use-cases\product\get-all-products.use-case.ts", "TypeScript", -26, 0, 0, 0, -8, -7, -41
"c:\Users\Usuario\Desktop\Practica Angular\14-back\src\domain\use-cases\product\get-all-unit.use-case.ts", "TypeScript", -28, 0, 0, 0, -3, -9, -40
"c:\Users\Usuario\Desktop\Practica Angular\14-back\src\domain\use-cases\product\get-category-by-id.use-case.ts", "TypeScript", -25, 0, 0, 0, -2, -5, -32
"c:\Users\Usuario\Desktop\Practica Angular\14-back\src\domain\use-cases\product\get-product-by-category.use-case.ts", "TypeScript", -27, 0, 0, 0, -7, -6, -40
"c:\Users\Usuario\Desktop\Practica Angular\14-back\src\domain\use-cases\product\get-unit-by-id.use-case.ts", "TypeScript", -26, 0, 0, 0, -2, -5, -33
"c:\Users\Usuario\Desktop\Practica Angular\14-back\src\domain\use-cases\product\search-products.use-case.ts", "TypeScript", -26, 0, 0, 0, -2, -3, -31
"c:\Users\Usuario\Desktop\Practica Angular\14-back\src\domain\use-cases\product\tag\create-tag.use-case.ts", "TypeScript", -15, 0, 0, 0, -1, -4, -20
"c:\Users\Usuario\Desktop\Practica Angular\14-back\src\domain\use-cases\product\tag\delete-tag.use-case.ts", "TypeScript", -14, 0, 0, 0, -2, -3, -19
"c:\Users\Usuario\Desktop\Practica Angular\14-back\src\domain\use-cases\product\tag\get-all-tags.use-case.ts", "TypeScript", -12, 0, 0, 0, -1, -3, -16
"c:\Users\Usuario\Desktop\Practica Angular\14-back\src\domain\use-cases\product\tag\get-tag-by-id.use-case.ts", "TypeScript", -14, 0, 0, 0, -1, -3, -18
"c:\Users\Usuario\Desktop\Practica Angular\14-back\src\domain\use-cases\product\tag\update-tag.use-case.ts", "TypeScript", -21, 0, 0, 0, -2, -5, -28
"c:\Users\Usuario\Desktop\Practica Angular\14-back\src\domain\use-cases\product\update-category.use-case.ts", "TypeScript", -27, 0, 0, 0, -2, -7, -36
"c:\Users\Usuario\Desktop\Practica Angular\14-back\src\domain\use-cases\product\update-product.use-case.ts", "TypeScript", -28, 0, 0, 0, -5, -8, -41
"c:\Users\Usuario\Desktop\Practica Angular\14-back\src\domain\use-cases\product\update-unit.use-case.ts", "TypeScript", -27, 0, 0, 0, -2, -6, -35
"c:\Users\Usuario\Desktop\Practica Angular\14-back\src\domain\use-cases\sales\create-sale.use-case.ts", "TypeScript", -32, 0, 0, 0, -5, -8, -45
"c:\Users\Usuario\Desktop\Practica Angular\14-back\src\domain\use-cases\sales\get-all-sales.use-case.ts", "TypeScript", -14, 0, 0, 0, -1, -5, -20
"c:\Users\Usuario\Desktop\Practica Angular\14-back\src\domain\use-cases\sales\get-sale-by-id.use-case.ts", "TypeScript", -18, 0, 0, 0, -1, -5, -24
"c:\Users\Usuario\Desktop\Practica Angular\14-back\src\domain\use-cases\sales\get-sales-by-customer.use-case.ts", "TypeScript", -14, 0, 0, 0, -1, -5, -20
"c:\Users\Usuario\Desktop\Practica Angular\14-back\src\domain\use-cases\sales\get-sales-by-status.use-case.ts", "TypeScript", -14, 0, 0, 0, -1, -5, -20
"c:\Users\Usuario\Desktop\Practica Angular\14-back\src\domain\use-cases\sales\update-sale-status.use-case.ts", "TypeScript", -25, 0, 0, 0, -4, -8, -37
"c:\Users\Usuario\Desktop\Practica Angular\14-back\src\domain\use-cases\user\delete-user.use-case.ts", "TypeScript", 0, 0, 0, 0, 0, -1, -1
"c:\Users\Usuario\Desktop\Practica Angular\14-back\src\domain\use-cases\user\update-user.use-case.ts", "TypeScript", 0, 0, 0, 0, 0, -1, -1
"c:\Users\Usuario\Desktop\Practica Angular\14-back\src\infrastructure\adapters\cloudinary-file-storage.adapter.ts", "TypeScript", -55, 0, 0, 0, -5, -13, -73
"c:\Users\Usuario\Desktop\Practica Angular\14-back\src\infrastructure\adapters\cloudinary.adapter.ts", "TypeScript", -50, 0, 0, 0, -6, -10, -66
"c:\Users\Usuario\Desktop\Practica Angular\14-back\src\infrastructure\adapters\langchain.adapter.ts", "TypeScript", -144, 0, 0, 0, -12, -19, -175
"c:\Users\Usuario\Desktop\Practica Angular\14-back\src\infrastructure\adapters\llm.adapter.ts", "TypeScript", -100, 0, 0, 0, -6, -17, -123
"c:\Users\Usuario\Desktop\Practica Angular\14-back\src\infrastructure\adapters\mercado-pago-payment.adapter.ts", "TypeScript", -233, 0, 0, 0, -4, -38, -275
"c:\Users\Usuario\Desktop\Practica Angular\14-back\src\infrastructure\adapters\mercado-pago.adapter.ts", "TypeScript", -154, 0, 0, 0, -13, -30, -197
"c:\Users\Usuario\Desktop\Practica Angular\14-back\src\infrastructure\adapters\nodemailer.adapter.ts", "TypeScript", -75, 0, 0, 0, -15, -13, -103
"c:\Users\Usuario\Desktop\Practica Angular\14-back\src\infrastructure\adapters\telegram-notification.adapter.ts", "TypeScript", -89, 0, 0, 0, -2, -16, -107
"c:\Users\Usuario\Desktop\Practica Angular\14-back\src\infrastructure\adapters\telegram.adapter.ts", "TypeScript", -67, 0, 0, 0, -1, -12, -80
"c:\Users\Usuario\Desktop\Practica Angular\14-back\src\infrastructure\adapters\transformers.adapter.ts", "TypeScript", -63, 0, 0, 0, -1, -13, -77
"c:\Users\Usuario\Desktop\Practica Angular\14-back\src\infrastructure\adapters\winston-logger.adapter.ts", "TypeScript", -29, 0, 0, 0, -3, -8, -40
"c:\Users\Usuario\Desktop\Practica Angular\14-back\src\infrastructure\datasources\auth.mongo.datasource.impl.ts", "TypeScript", -135, 0, 0, 0, -13, -19, -167
"c:\Users\Usuario\Desktop\Practica Angular\14-back\src\infrastructure\datasources\cart\cart.mongo.datasource.impl.ts", "TypeScript", -181, 0, 0, 0, -16, -32, -229
"c:\Users\Usuario\Desktop\Practica Angular\14-back\src\infrastructure\datasources\chatbot\chat.mongo.datasource.impl.ts", "TypeScript", -458, 0, 0, 0, -53, -91, -602
"c:\Users\Usuario\Desktop\Practica Angular\14-back\src\infrastructure\datasources\coupon\coupon.mongo.datasource.impl.ts", "TypeScript", -131, 0, 0, 0, -10, -16, -157
"c:\Users\Usuario\Desktop\Practica Angular\14-back\src\infrastructure\datasources\customers\city.mongo.datasource.impl.ts", "TypeScript", -97, 0, 0, 0, -5, -17, -119
"c:\Users\Usuario\Desktop\Practica Angular\14-back\src\infrastructure\datasources\customers\customer.mongo.datasource.impl.ts", "TypeScript", -370, 0, 0, 0, -16, -28, -414
"c:\Users\Usuario\Desktop\Practica Angular\14-back\src\infrastructure\datasources\customers\neighborhood.mongo.datasource.impl.ts", "TypeScript", -126, 0, 0, 0, -7, -26, -159
"c:\Users\Usuario\Desktop\Practica Angular\14-back\src\infrastructure\datasources\mcp\mcp.datasource.impl.ts", "TypeScript", -353, 0, 0, 0, -4, -35, -392
"c:\Users\Usuario\Desktop\Practica Angular\14-back\src\infrastructure\datasources\order\order-status.mongo.datasource.impl.ts", "TypeScript", -162, 0, 0, 0, -7, -41, -210
"c:\Users\Usuario\Desktop\Practica Angular\14-back\src\infrastructure\datasources\order\order.mongo.datasource.impl.ts", "TypeScript", -499, 0, 0, 0, -35, -71, -605
"c:\Users\Usuario\Desktop\Practica Angular\14-back\src\infrastructure\datasources\payment\payment-method.mongo.datasource.impl.ts", "TypeScript", -145, 0, 0, 0, -6, -34, -185
"c:\Users\Usuario\Desktop\Practica Angular\14-back\src\infrastructure\datasources\payment\payment.mongo.datasource.impl.ts", "TypeScript", -343, 0, 0, 0, -22, -43, -408
"c:\Users\Usuario\Desktop\Practica Angular\14-back\src\infrastructure\datasources\products\category.mongo.datasource.impl.ts", "TypeScript", -88, 0, 0, 0, -22, -54, -164
"c:\Users\Usuario\Desktop\Practica Angular\14-back\src\infrastructure\datasources\products\product.mongo.datasource.impl.ts", "TypeScript", -263, 0, 0, 0, -17, -25, -305
"c:\Users\Usuario\Desktop\Practica Angular\14-back\src\infrastructure\datasources\products\tag.mongo.datasource.impl.ts", "TypeScript", -104, 0, 0, 0, -6, -13, -123
"c:\Users\Usuario\Desktop\Practica Angular\14-back\src\infrastructure\datasources\products\unit.mongo.datasource.impl.ts", "TypeScript", -95, 0, 0, 0, -24, -52, -171
"c:\Users\Usuario\Desktop\Practica Angular\14-back\src\infrastructure\datasources\sales\sale.mongo.datasource.impl.ts", "TypeScript", -254, 0, 0, 0, -10, -32, -296
"c:\Users\Usuario\Desktop\Practica Angular\14-back\src\infrastructure\mappers\cart\cart-item.mapper.ts", "TypeScript", -74, 0, 0, 0, -20, -10, -104
"c:\Users\Usuario\Desktop\Practica Angular\14-back\src\infrastructure\mappers\cart\cart.mapper.ts", "TypeScript", -54, 0, 0, 0, -7, -7, -68
"c:\Users\Usuario\Desktop\Practica Angular\14-back\src\infrastructure\mappers\coupon\coupon.mapper.ts", "TypeScript", -33, 0, 0, 0, -2, -5, -40
"c:\Users\Usuario\Desktop\Practica Angular\14-back\src\infrastructure\mappers\customers\address.mapper.ts", "TypeScript", -73, 0, 0, 0, -2, -7, -82
"c:\Users\Usuario\Desktop\Practica Angular\14-back\src\infrastructure\mappers\customers\city.mapper.ts", "TypeScript", -25, 0, 0, 0, -3, -6, -34
"c:\Users\Usuario\Desktop\Practica Angular\14-back\src\infrastructure\mappers\customers\customer.mapper.ts", "TypeScript", -55, 0, 0, 0, -10, -10, -75
"c:\Users\Usuario\Desktop\Practica Angular\14-back\src\infrastructure\mappers\customers\neighborhood.mapper.ts", "TypeScript", -32, 0, 0, 0, -4, -7, -43
"c:\Users\Usuario\Desktop\Practica Angular\14-back\src\infrastructure\mappers\order\order-status.mapper.ts", "TypeScript", -19, 0, 0, 0, -1, -3, -23
"c:\Users\Usuario\Desktop\Practica Angular\14-back\src\infrastructure\mappers\order\order.mapper.ts", "TypeScript", -141, 0, 0, 0, -8, -7, -156
"c:\Users\Usuario\Desktop\Practica Angular\14-back\src\infrastructure\mappers\payment\payment-method.mapper.ts", "TypeScript", -49, 0, 0, 0, -1, -5, -55
"c:\Users\Usuario\Desktop\Practica Angular\14-back\src\infrastructure\mappers\payment\payment.mapper.ts", "TypeScript", -127, 0, 0, 0, -6, -8, -141
"c:\Users\Usuario\Desktop\Practica Angular\14-back\src\infrastructure\mappers\products\category.mapper.ts", "TypeScript", -17, 0, 0, 0, -7, -7, -31
"c:\Users\Usuario\Desktop\Practica Angular\14-back\src\infrastructure\mappers\products\product.mapper.ts", "TypeScript", -72, 0, 0, 0, -13, -11, -96
"c:\Users\Usuario\Desktop\Practica Angular\14-back\src\infrastructure\mappers\products\tag.mapper.ts", "TypeScript", -17, 0, 0, 0, -1, -3, -21
"c:\Users\Usuario\Desktop\Practica Angular\14-back\src\infrastructure\mappers\products\unit.mapper.ts", "TypeScript", -17, 0, 0, 0, -7, -5, -29
"c:\Users\Usuario\Desktop\Practica Angular\14-back\src\infrastructure\mappers\sales\sale.mapper.ts", "TypeScript", -100, 0, 0, 0, -11, -11, -122
"c:\Users\Usuario\Desktop\Practica Angular\14-back\src\infrastructure\mappers\user.mapper.ts", "TypeScript", -19, 0, 0, 0, -4, -5, -28
"c:\Users\Usuario\Desktop\Practica Angular\14-back\src\infrastructure\notifications\email.channel.ts", "TypeScript", -64, 0, 0, 0, -1, -9, -74
"c:\Users\Usuario\Desktop\Practica Angular\14-back\src\infrastructure\notifications\telegram.channel.ts", "TypeScript", -24, 0, 0, 0, -1, -8, -33
"c:\Users\Usuario\Desktop\Practica Angular\14-back\src\infrastructure\repositories\auth.repository.impl.ts", "TypeScript", -29, 0, 0, 0, -3, -9, -41
"c:\Users\Usuario\Desktop\Practica Angular\14-back\src\infrastructure\repositories\cart\cart.repository.impl.ts", "TypeScript", -25, 0, 0, 0, 0, -7, -32
"c:\Users\Usuario\Desktop\Practica Angular\14-back\src\infrastructure\repositories\chatbot\chat.repository.impl.ts", "TypeScript", -30, 0, 0, 0, -1, -8, -39
"c:\Users\Usuario\Desktop\Practica Angular\14-back\src\infrastructure\repositories\coupon\coupon.repository.impl.ts", "TypeScript", -32, 0, 0, 0, -1, -9, -42
"c:\Users\Usuario\Desktop\Practica Angular\14-back\src\infrastructure\repositories\customers\city.repository.impl.ts", "TypeScript", -30, 0, 0, 0, -1, -9, -40
"c:\Users\Usuario\Desktop\Practica Angular\14-back\src\infrastructure\repositories\customers\customer.repository.impl.ts", "TypeScript", -54, 0, 0, 0, -4, -4, -62
"c:\Users\Usuario\Desktop\Practica Angular\14-back\src\infrastructure\repositories\customers\neighborhood.repository.impl.ts", "TypeScript", -33, 0, 0, 0, -1, -10, -44
"c:\Users\Usuario\Desktop\Practica Angular\14-back\src\infrastructure\repositories\mcp\mcp.repository.impl.ts", "TypeScript", -16, 0, 0, 0, -1, -4, -21
"c:\Users\Usuario\Desktop\Practica Angular\14-back\src\infrastructure\repositories\order\order-status.repository.impl.ts", "TypeScript", -35, 0, 0, 0, -1, -10, -46
"c:\Users\Usuario\Desktop\Practica Angular\14-back\src\infrastructure\repositories\order\order.repository.impl.ts", "TypeScript", -53, 0, 0, 0, -9, -10, -72
"c:\Users\Usuario\Desktop\Practica Angular\14-back\src\infrastructure\repositories\payment\payment-method.repository.impl.ts", "TypeScript", -30, 0, 0, 0, -1, -11, -42
"c:\Users\Usuario\Desktop\Practica Angular\14-back\src\infrastructure\repositories\payment\payment.repository.impl.ts", "TypeScript", -51, 0, 0, 0, -1, -16, -68
"c:\Users\Usuario\Desktop\Practica Angular\14-back\src\infrastructure\repositories\products\category.respository.impl.ts", "TypeScript", -32, 0, 0, 0, 0, -13, -45
"c:\Users\Usuario\Desktop\Practica Angular\14-back\src\infrastructure\repositories\products\product.repository.impl.ts", "TypeScript", -40, 0, 0, 0, -3, -4, -47
"c:\Users\Usuario\Desktop\Practica Angular\14-back\src\infrastructure\repositories\products\tag.repository.impl.ts", "TypeScript", -27, 0, 0, 0, -1, -2, -30
"c:\Users\Usuario\Desktop\Practica Angular\14-back\src\infrastructure\repositories\products\unit.repository.impl.ts", "TypeScript", -30, 0, 0, 0, 0, -9, -39
"c:\Users\Usuario\Desktop\Practica Angular\14-back\src\infrastructure\repositories\sales\sale.repository.impl.ts", "TypeScript", -31, 0, 0, 0, -1, -8, -40
"c:\Users\Usuario\Desktop\Practica Angular\14-back\src\infrastructure\services\notification.service.impl.ts", "TypeScript", -64, 0, 0, 0, -1, -7, -72
"c:\Users\Usuario\Desktop\Practica Angular\14-back\src\infrastructure\services\notification.service.ts", "TypeScript", -82, 0, 0, 0, -2, -11, -95
"c:\Users\Usuario\Desktop\Practica Angular\14-back\src\presentation\admin\coupons\routes.admin.coupon.ts", "TypeScript", -18, 0, 0, 0, -3, -4, -25
"c:\Users\Usuario\Desktop\Practica Angular\14-back\src\presentation\admin\customers\routes.admin.city.ts", "TypeScript", -19, 0, 0, 0, -3, -4, -26
"c:\Users\Usuario\Desktop\Practica Angular\14-back\src\presentation\admin\customers\routes.admin.customer.ts", "TypeScript", -24, 0, 0, 0, -3, -4, -31
"c:\Users\Usuario\Desktop\Practica Angular\14-back\src\presentation\admin\customers\routes.admin.neighborhood.ts", "TypeScript", -23, 0, 0, 0, -3, -4, -30
"c:\Users\Usuario\Desktop\Practica Angular\14-back\src\presentation\admin\orders\routes.admin.order.ts", "TypeScript", -62, 0, 0, 0, -3, -5, -70
"c:\Users\Usuario\Desktop\Practica Angular\14-back\src\presentation\admin\products\routes.admin.category.ts", "TypeScript", -18, 0, 0, 0, -1, -3, -22
"c:\Users\Usuario\Desktop\Practica Angular\14-back\src\presentation\admin\products\routes.admin.product.ts", "TypeScript", -30, 0, 0, 0, -3, -5, -38
"c:\Users\Usuario\Desktop\Practica Angular\14-back\src\presentation\admin\products\routes.admin.unit.ts", "TypeScript", -18, 0, 0, 0, -3, -4, -25
"c:\Users\Usuario\Desktop\Practica Angular\14-back\src\presentation\admin\routes.admin.ts", "TypeScript", -30, 0, 0, 0, -3, -4, -37
"c:\Users\Usuario\Desktop\Practica Angular\14-back\src\presentation\admin\tags\routes.admin.tag.ts", "TypeScript", -18, 0, 0, 0, -3, -4, -25
"c:\Users\Usuario\Desktop\Practica Angular\14-back\src\presentation\admin\users\routes.admin.user.ts", "TypeScript", -23, 0, 0, 0, -3, -5, -31
"c:\Users\Usuario\Desktop\Practica Angular\14-back\src\presentation\auth\controller.auth.ts", "TypeScript", -143, 0, 0, 0, -17, -21, -181
"c:\Users\Usuario\Desktop\Practica Angular\14-back\src\presentation\auth\routes.auth.ts", "TypeScript", -29, 0, 0, 0, -5, -7, -41
"c:\Users\Usuario\Desktop\Practica Angular\14-back\src\presentation\cart\controller.cart.ts", "TypeScript", -128, 0, 0, 0, -3, -16, -147
"c:\Users\Usuario\Desktop\Practica Angular\14-back\src\presentation\cart\routes.cart.ts", "TypeScript", -24, 0, 0, 0, -4, -8, -36
"c:\Users\Usuario\Desktop\Practica Angular\14-back\src\presentation\chatbot\controller.chatbot.ts", "TypeScript", -98, 0, 0, 0, -10, -21, -129
"c:\Users\Usuario\Desktop\Practica Angular\14-back\src\presentation\chatbot\routes.chatbot.ts", "TypeScript", -22, 0, 0, 0, -4, -6, -32
"c:\Users\Usuario\Desktop\Practica Angular\14-back\src\presentation\coupon\controller.coupon.ts", "TypeScript", -80, 0, 0, 0, -2, -16, -98
"c:\Users\Usuario\Desktop\Practica Angular\14-back\src\presentation\coupon\routes.coupon.ts", "TypeScript", -20, 0, 0, 0, -6, -6, -32
"c:\Users\Usuario\Desktop\Practica Angular\14-back\src\presentation\customers\controller.address.ts", "TypeScript", -70, 0, 0, 0, -6, -14, -90
"c:\Users\Usuario\Desktop\Practica Angular\14-back\src\presentation\customers\controller.city.ts", "TypeScript", -88, 0, 0, 0, 0, -23, -111
"c:\Users\Usuario\Desktop\Practica Angular\14-back\src\presentation\customers\controller.customer.ts", "TypeScript", -114, 0, 0, 0, 0, -25, -139
"c:\Users\Usuario\Desktop\Practica Angular\14-back\src\presentation\customers\controller.neighborhood.ts", "TypeScript", -101, 0, 0, 0, 0, -23, -124
"c:\Users\Usuario\Desktop\Practica Angular\14-back\src\presentation\customers\routes.address.ts", "TypeScript", -24, 0, 0, 0, -5, -5, -34
"c:\Users\Usuario\Desktop\Practica Angular\14-back\src\presentation\customers\routes.city.ts", "TypeScript", -19, 0, 0, 0, -3, -5, -27
"c:\Users\Usuario\Desktop\Practica Angular\14-back\src\presentation\customers\routes.customer.ts", "TypeScript", -24, 0, 0, 0, -3, -5, -32
"c:\Users\Usuario\Desktop\Practica Angular\14-back\src\presentation\customers\routes.neighborhood.ts", "TypeScript", -23, 0, 0, 0, -3, -5, -31
"c:\Users\Usuario\Desktop\Practica Angular\14-back\src\presentation\mcp\controller.mcp.ts", "TypeScript", -73, 0, 0, 0, -11, -20, -104
"c:\Users\Usuario\Desktop\Practica Angular\14-back\src\presentation\mcp\routes.mcp.ts", "TypeScript", -11, 0, 0, 0, -3, -5, -19
"c:\Users\Usuario\Desktop\Practica Angular\14-back\src\presentation\middlewares\auth.middleware.ts", "TypeScript", -66, 0, 0, 0, -2, -16, -84
"c:\Users\Usuario\Desktop\Practica Angular\14-back\src\presentation\middlewares\logger.middleware.ts", "TypeScript", -141, 0, 0, 0, -25, -27, -193
"c:\Users\Usuario\Desktop\Practica Angular\14-back\src\presentation\middlewares\rate-limit.middleware.ts", "TypeScript", -95, 0, 0, 0, -10, -15, -120
"c:\Users\Usuario\Desktop\Practica Angular\14-back\src\presentation\middlewares\upload.middleware.ts", "TypeScript", -61, 0, 0, 0, -13, -8, -82
"c:\Users\Usuario\Desktop\Practica Angular\14-back\src\presentation\monitoring\controller.monitoring.ts", "TypeScript", -433, 0, 0, 0, -8, -29, -470
"c:\Users\Usuario\Desktop\Practica Angular\14-back\src\presentation\monitoring\routes.monitoring.ts", "TypeScript", -18, 0, 0, 0, -2, -5, -25
"c:\Users\Usuario\Desktop\Practica Angular\14-back\src\presentation\order\controller.order-status.ts", "TypeScript", -137, 0, 0, 0, -11, -28, -176
"c:\Users\Usuario\Desktop\Practica Angular\14-back\src\presentation\order\controller.order.ts", "TypeScript", -230, 0, 0, 0, -10, -29, -269
"c:\Users\Usuario\Desktop\Practica Angular\14-back\src\presentation\order\routes.order-status.ts", "TypeScript", -53, 0, 0, 0, -5, -6, -64
"c:\Users\Usuario\Desktop\Practica Angular\14-back\src\presentation\order\routes.order.ts", "TypeScript", -65, 0, 0, 0, -6, -5, -76
"c:\Users\Usuario\Desktop\Practica Angular\14-back\src\presentation\payment\controller.payment-method.ts", "TypeScript", -107, 0, 0, 0, -8, -22, -137
"c:\Users\Usuario\Desktop\Practica Angular\14-back\src\presentation\payment\controller.payment.ts", "TypeScript", -512, 0, 0, 0, -24, -84, -620
"c:\Users\Usuario\Desktop\Practica Angular\14-back\src\presentation\payment\routes.payment-method.ts", "TypeScript", -41, 0, 0, 0, -5, -7, -53
"c:\Users\Usuario\Desktop\Practica Angular\14-back\src\presentation\payment\routes.payment.ts", "TypeScript", -43, 0, 0, 0, -8, -9, -60
"c:\Users\Usuario\Desktop\Practica Angular\14-back\src\presentation\products\controller.category.ts", "TypeScript", -75, 0, 0, 0, -14, -33, -122
"c:\Users\Usuario\Desktop\Practica Angular\14-back\src\presentation\products\controller.product.ts", "TypeScript", -257, 0, 0, 0, -7, -18, -282
"c:\Users\Usuario\Desktop\Practica Angular\14-back\src\presentation\products\controller.tag.ts", "TypeScript", -62, 0, 0, 0, -1, -11, -74
"c:\Users\Usuario\Desktop\Practica Angular\14-back\src\presentation\products\controller.unit.ts", "TypeScript", -73, 0, 0, 0, -11, -28, -112
"c:\Users\Usuario\Desktop\Practica Angular\14-back\src\presentation\products\routes.category..ts", "TypeScript", -18, 0, 0, 0, -2, -5, -25
"c:\Users\Usuario\Desktop\Practica Angular\14-back\src\presentation\products\routes.product.ts", "TypeScript", -30, 0, 0, 0, -26, -8, -64
"c:\Users\Usuario\Desktop\Practica Angular\14-back\src\presentation\products\routes.tag.ts", "TypeScript", -15, 0, 0, 0, -4, -6, -25
"c:\Users\Usuario\Desktop\Practica Angular\14-back\src\presentation\products\routes.unit.ts", "TypeScript", -18, 0, 0, 0, -2, -4, -24
"c:\Users\Usuario\Desktop\Practica Angular\14-back\src\presentation\routes.ts", "TypeScript", -79, 0, 0, 0, -7, -13, -99
"c:\Users\Usuario\Desktop\Practica Angular\14-back\src\presentation\sales\controller.ts", "TypeScript", -107, 0, 0, 0, -1, -23, -131
"c:\Users\Usuario\Desktop\Practica Angular\14-back\src\presentation\sales\routes.ts", "TypeScript", -46, 0, 0, 0, -5, -8, -59
"c:\Users\Usuario\Desktop\Practica Angular\14-back\src\presentation\server.ts", "TypeScript", -105, 0, 0, 0, -12, -21, -138
"c:\Users\Usuario\Desktop\Practica Angular\14-back\src\seeders\index.ts", "TypeScript", -33, 0, 0, 0, -4, -8, -45
"c:\Users\Usuario\Desktop\Practica Angular\14-back\src\seeders\order-status.seeder.ts", "TypeScript", -133, 0, 0, 0, -6, -13, -152
"c:\Users\Usuario\Desktop\Practica Angular\14-back\src\seeders\payment-method.seeder.ts", "TypeScript", -99, 0, 0, 0, -6, -15, -120
"c:\Users\Usuario\Desktop\Practica Angular\14-back\tests\domain\dtos\auth\register-user.dto.test.js", "JavaScript", 0, 65, 0, 0, 25, 1, 91
"c:\Users\Usuario\Desktop\Practica Angular\14-back\tests\domain\dtos\auth\register-user.dto.test.ts", "TypeScript", 63, 0, 0, 0, 25, 19, 107
"c:\Users\Usuario\Desktop\Practica Angular\14-back\tests\domain\dtos\customers\create-city.dto.test.js", "JavaScript", 0, 63, 0, 0, 25, 1, 89
"c:\Users\Usuario\Desktop\Practica Angular\14-back\tests\domain\dtos\customers\create-city.dto.test.ts", "TypeScript", 61, 0, 0, 0, 25, 19, 105
"c:\Users\Usuario\Desktop\Practica Angular\14-back\tests\domain\dtos\customers\create-customer.dto.test.js", "JavaScript", 0, 170, 0, 0, 54, 1, 225
"c:\Users\Usuario\Desktop\Practica Angular\14-back\tests\domain\dtos\customers\create-customer.dto.test.ts", "TypeScript", 165, 0, 0, 0, 54, 41, 260
"c:\Users\Usuario\Desktop\Practica Angular\14-back\tests\domain\dtos\customers\create-neighborhood.dto.test.js", "JavaScript", 0, 94, 0, 0, 34, 1, 129
"c:\Users\Usuario\Desktop\Practica Angular\14-back\tests\domain\dtos\customers\create-neighborhood.dto.test.ts", "TypeScript", 89, 0, 0, 0, 34, 26, 149
"c:\Users\Usuario\Desktop\Practica Angular\14-back\tests\domain\dtos\customers\update-city.dto.test.js", "JavaScript", 0, 61, 0, 0, 26, 1, 88
"c:\Users\Usuario\Desktop\Practica Angular\14-back\tests\domain\dtos\customers\update-city.dto.test.ts", "TypeScript", 59, 0, 0, 0, 26, 20, 105
"c:\Users\Usuario\Desktop\Practica Angular\14-back\tests\domain\dtos\customers\update-customer.dto.test.js", "JavaScript", 0, 75, 0, 0, 25, 1, 101
"c:\Users\Usuario\Desktop\Practica Angular\14-back\tests\domain\dtos\customers\update-customer.dto.test.ts", "TypeScript", 70, 0, 0, 0, 25, 20, 115
"c:\Users\Usuario\Desktop\Practica Angular\14-back\tests\domain\dtos\customers\update-neighborhood.dto.test.js", "JavaScript", 0, 78, 0, 0, 31, 1, 110
"c:\Users\Usuario\Desktop\Practica Angular\14-back\tests\domain\dtos\customers\update-neighborhood.dto.test.ts", "TypeScript", 73, 0, 0, 0, 31, 24, 128
"c:\Users\Usuario\Desktop\Practica Angular\14-back\tests\domain\dtos\payment\create-payment.dto.test.js", "JavaScript", 0, 194, 0, 0, 28, 1, 223
"c:\Users\Usuario\Desktop\Practica Angular\14-back\tests\domain\dtos\payment\create-payment.dto.test.ts", "TypeScript", 196, 0, 0, 0, 28, 67, 291
"c:\Users\Usuario\Desktop\Practica Angular\14-back\tests\domain\dtos\payment\process-webhook.dto.test.js", "JavaScript", 0, 88, 0, 0, 28, 1, 117
"c:\Users\Usuario\Desktop\Practica Angular\14-back\tests\domain\dtos\payment\process-webhook.dto.test.ts", "TypeScript", 95, 0, 0, 0, 28, 28, 151
"c:\Users\Usuario\Desktop\Practica Angular\14-back\tests\domain\dtos\payment\update-payment-status.dto.test.js", "JavaScript", 0, 94, 0, 0, 31, 1, 126
"c:\Users\Usuario\Desktop\Practica Angular\14-back\tests\domain\dtos\payment\update-payment-status.dto.test.ts", "TypeScript", 98, 0, 0, 0, 31, 28, 157
"c:\Users\Usuario\Desktop\Practica Angular\14-back\tests\domain\dtos\payment\verify-payment.dto.test.js", "JavaScript", 0, 88, 0, 0, 30, 1, 119
"c:\Users\Usuario\Desktop\Practica Angular\14-back\tests\domain\dtos\payment\verify-payment.dto.test.ts", "TypeScript", 89, 0, 0, 0, 30, 28, 147
"c:\Users\Usuario\Desktop\Practica Angular\14-back\tests\domain\dtos\products\create-category.dto.test.js", "JavaScript", 0, 77, 0, 0, 31, 1, 109
"c:\Users\Usuario\Desktop\Practica Angular\14-back\tests\domain\dtos\products\create-category.dto.test.ts", "TypeScript", 75, 0, 0, 0, 31, 21, 127
"c:\Users\Usuario\Desktop\Practica Angular\14-back\tests\domain\dtos\products\create-product.dto.test.js", "JavaScript", 0, 172, 0, 0, 44, 1, 217
"c:\Users\Usuario\Desktop\Practica Angular\14-back\tests\domain\dtos\products\create-product.dto.test.ts", "TypeScript", 183, 0, 0, 0, 48, 37, 268
"c:\Users\Usuario\Desktop\Practica Angular\14-back\tests\domain\dtos\products\create-unit.dto.test.js", "JavaScript", 0, 98, 0, 0, 38, 1, 137
"c:\Users\Usuario\Desktop\Practica Angular\14-back\tests\domain\dtos\products\create-unit.dto.test.ts", "TypeScript", 96, 0, 0, 0, 38, 29, 163
"c:\Users\Usuario\Desktop\Practica Angular\14-back\tests\domain\dtos\products\update-category.dto.test.js", "JavaScript", 0, 83, 0, 0, 36, 1, 120
"c:\Users\Usuario\Desktop\Practica Angular\14-back\tests\domain\dtos\products\update-category.dto.test.ts", "TypeScript", 81, 0, 0, 0, 36, 28, 145
"c:\Users\Usuario\Desktop\Practica Angular\14-back\tests\domain\dtos\products\update-product.dto.test.js", "JavaScript", 0, 106, 0, 0, 36, 1, 143
"c:\Users\Usuario\Desktop\Practica Angular\14-back\tests\domain\dtos\products\update-product.dto.test.ts", "TypeScript", 101, 0, 0, 0, 36, 28, 165
"c:\Users\Usuario\Desktop\Practica Angular\14-back\tests\domain\dtos\products\update-unit.dto.test.js", "JavaScript", 0, 85, 0, 0, 31, 1, 117
"c:\Users\Usuario\Desktop\Practica Angular\14-back\tests\domain\dtos\products\update-unit.dto.test.ts", "TypeScript", 83, 0, 0, 0, 31, 23, 137
"c:\Users\Usuario\Desktop\Practica Angular\14-back\tests\domain\dtos\sales\create-sale.dto.test.js", "JavaScript", 0, 162, 0, 0, 55, 1, 218
"c:\Users\Usuario\Desktop\Practica Angular\14-back\tests\domain\dtos\sales\create-sale.dto.test.ts", "TypeScript", 184, 0, 0, 0, 55, 41, 280
"c:\Users\Usuario\Desktop\Practica Angular\14-back\tests\domain\dtos\sales\update-sale-status.dto.test.js", "JavaScript", 0, 82, 0, 0, 37, 1, 120
"c:\Users\Usuario\Desktop\Practica Angular\14-back\tests\domain\dtos\sales\update-sale-status.dto.test.ts", "TypeScript", 79, 0, 0, 0, 37, 25, 141
"c:\Users\Usuario\Desktop\Practica Angular\14-back\tests\domain\dtos\shared\pagination.dto.test.js", "JavaScript", 0, 52, 0, 0, 23, 1, 76
"c:\Users\Usuario\Desktop\Practica Angular\14-back\tests\domain\dtos\shared\pagination.dto.test.ts", "TypeScript", 49, 0, 0, 0, 23, 16, 88
"c:\Users\Usuario\Desktop\Practica Angular\14-back\tests\domain\entities\customers\city.entity.test.js", "JavaScript", 0, 60, 0, 0, 29, 1, 90
"c:\Users\Usuario\Desktop\Practica Angular\14-back\tests\domain\entities\customers\city.entity.test.ts", "TypeScript", 58, 0, 0, 0, 29, 19, 106
"c:\Users\Usuario\Desktop\Practica Angular\14-back\tests\domain\entities\customers\customer.entity.test.js", "JavaScript", 0, 70, 0, 0, 21, 1, 92
"c:\Users\Usuario\Desktop\Practica Angular\14-back\tests\domain\entities\customers\customer.entity.test.ts", "TypeScript", 118, 0, 0, 0, 21, 17, 156
"c:\Users\Usuario\Desktop\Practica Angular\14-back\tests\domain\entities\customers\neighborhood.entity.test.js", "JavaScript", 0, 68, 0, 0, 25, 1, 94
"c:\Users\Usuario\Desktop\Practica Angular\14-back\tests\domain\entities\customers\neighborhood.entity.test.ts", "TypeScript", 118, 0, 0, 0, 25, 20, 163
"c:\Users\Usuario\Desktop\Practica Angular\14-back\tests\domain\entities\payment\payment.entity.test.js", "JavaScript", 0, 121, 0, 0, 27, 1, 149
"c:\Users\Usuario\Desktop\Practica Angular\14-back\tests\domain\entities\payment\payment.entity.test.ts", "TypeScript", 338, 0, 0, 0, 43, 33, 414
"c:\Users\Usuario\Desktop\Practica Angular\14-back\tests\domain\use-cases\auth\register-user.use-case.test.js", "JavaScript", 0, 82, 0, 0, 22, 1, 105
"c:\Users\Usuario\Desktop\Practica Angular\14-back\tests\domain\use-cases\auth\register-user.use-case.test.ts", "TypeScript", 117, 0, 0, 0, 17, 27, 161
"c:\Users\Usuario\Desktop\Practica Angular\14-back\tests\domain\use-cases\customers\create-city.use-case.test.js", "JavaScript", 0, 102, 0, 0, 32, 1, 135
"c:\Users\Usuario\Desktop\Practica Angular\14-back\tests\domain\use-cases\customers\create-city.use-case.test.ts", "TypeScript", 99, 0, 0, 0, 32, 28, 159
"c:\Users\Usuario\Desktop\Practica Angular\14-back\tests\domain\use-cases\customers\create-customer.use-case.test.js", "JavaScript", 0, 126, 0, 0, 30, 1, 157
"c:\Users\Usuario\Desktop\Practica Angular\14-back\tests\domain\use-cases\customers\create-customer.use-case.test.ts", "TypeScript", 145, 0, 0, 0, 31, 32, 208
"c:\Users\Usuario\Desktop\Practica Angular\14-back\tests\domain\use-cases\customers\create-neighborhood.use-case.test.js", "JavaScript", 0, 134, 0, 0, 37, 1, 172
"c:\Users\Usuario\Desktop\Practica Angular\14-back\tests\domain\use-cases\customers\create-neighborhood.use-case.test.ts", "TypeScript", 142, 0, 0, 0, 37, 36, 215
"c:\Users\Usuario\Desktop\Practica Angular\14-back\tests\domain\use-cases\customers\delete-city.use-case.test.js", "JavaScript", 0, 83, 0, 0, 21, 1, 105
"c:\Users\Usuario\Desktop\Practica Angular\14-back\tests\domain\use-cases\customers\delete-city.use-case.test.ts", "TypeScript", 73, 0, 0, 0, 21, 23, 117
"c:\Users\Usuario\Desktop\Practica Angular\14-back\tests\domain\use-cases\customers\delete-customer.use-case.test.js", "JavaScript", 0, 119, 0, 0, 18, 1, 138
"c:\Users\Usuario\Desktop\Practica Angular\14-back\tests\domain\use-cases\customers\delete-customer.use-case.test.ts", "TypeScript", 119, 0, 0, 0, 18, 29, 166
"c:\Users\Usuario\Desktop\Practica Angular\14-back\tests\domain\use-cases\customers\delete-neighborhood.use-case.test.js", "JavaScript", 0, 114, 0, 0, 18, 1, 133
"c:\Users\Usuario\Desktop\Practica Angular\14-back\tests\domain\use-cases\customers\delete-neighborhood.use-case.test.ts", "TypeScript", 87, 0, 0, 0, 18, 26, 131
"c:\Users\Usuario\Desktop\Practica Angular\14-back\tests\domain\use-cases\customers\find-city-by-name.use-case.test.js", "JavaScript", 0, 121, 0, 0, 32, 1, 154
"c:\Users\Usuario\Desktop\Practica Angular\14-back\tests\domain\use-cases\customers\find-city-by-name.use-case.test.ts", "TypeScript", 96, 0, 0, 0, 32, 38, 166
"c:\Users\Usuario\Desktop\Practica Angular\14-back\tests\domain\use-cases\customers\find-customers-by-neighborhood.use-case.test.js", "JavaScript", 0, 220, 0, 0, 47, 1, 268
"c:\Users\Usuario\Desktop\Practica Angular\14-back\tests\domain\use-cases\customers\find-customers-by-neighborhood.use-case.test.ts", "TypeScript", 206, 0, 0, 0, 47, 62, 315
"c:\Users\Usuario\Desktop\Practica Angular\14-back\tests\domain\use-cases\customers\find-neighborhoods-by-city.use-case.test.js", "JavaScript", 0, 210, 0, 0, 47, 1, 258
"c:\Users\Usuario\Desktop\Practica Angular\14-back\tests\domain\use-cases\customers\find-neighborhoods-by-city.use-case.test.ts", "TypeScript", 172, 0, 0, 0, 47, 59, 278
"c:\Users\Usuario\Desktop\Practica Angular\14-back\tests\domain\use-cases\customers\get-all-cities.use-case.test.js", "JavaScript", 0, 133, 0, 0, 32, 1, 166
"c:\Users\Usuario\Desktop\Practica Angular\14-back\tests\domain\use-cases\customers\get-all-cities.use-case.test.ts", "TypeScript", 108, 0, 0, 0, 32, 38, 178
"c:\Users\Usuario\Desktop\Practica Angular\14-back\tests\domain\use-cases\customers\get-all-customers.use-case.test.js", "JavaScript", 0, 154, 0, 0, 32, 1, 187
"c:\Users\Usuario\Desktop\Practica Angular\14-back\tests\domain\use-cases\customers\get-all-customers.use-case.test.ts", "TypeScript", 153, 0, 0, 0, 32, 41, 226
"c:\Users\Usuario\Desktop\Practica Angular\14-back\tests\domain\use-cases\customers\get-all-neighborhoods.use-case.test.js", "JavaScript", 0, 147, 0, 0, 33, 1, 181
"c:\Users\Usuario\Desktop\Practica Angular\14-back\tests\domain\use-cases\customers\get-all-neighborhoods.use-case.test.ts", "TypeScript", 120, 0, 0, 0, 33, 40, 193
"c:\Users\Usuario\Desktop\Practica Angular\14-back\tests\domain\use-cases\customers\get-city-by-id.use-case.test.js", "JavaScript", 0, 101, 0, 0, 21, 1, 123
"c:\Users\Usuario\Desktop\Practica Angular\14-back\tests\domain\use-cases\customers\get-city-by-id.use-case.test.ts", "TypeScript", 76, 0, 0, 0, 21, 27, 124
"c:\Users\Usuario\Desktop\Practica Angular\14-back\tests\domain\use-cases\customers\get-customer-by-email.use-case.test.js", "JavaScript", 0, 118, 0, 0, 24, 1, 143
"c:\Users\Usuario\Desktop\Practica Angular\14-back\tests\domain\use-cases\customers\get-customer-by-email.use-case.test.ts", "TypeScript", 118, 0, 0, 0, 24, 32, 174
"c:\Users\Usuario\Desktop\Practica Angular\14-back\tests\domain\use-cases\customers\get-customer-by-id.use-case.test.js", "JavaScript", 0, 116, 0, 0, 20, 1, 137
"c:\Users\Usuario\Desktop\Practica Angular\14-back\tests\domain\use-cases\customers\get-customer-by-id.use-case.test.ts", "TypeScript", 116, 0, 0, 0, 20, 29, 165
"c:\Users\Usuario\Desktop\Practica Angular\14-back\tests\domain\use-cases\customers\get-neighborhood-by-id.use-case.test.js", "JavaScript", 0, 110, 0, 0, 20, 1, 131
"c:\Users\Usuario\Desktop\Practica Angular\14-back\tests\domain\use-cases\customers\get-neighborhood-by-id.use-case.test.ts", "TypeScript", 83, 0, 0, 0, 20, 26, 129
"c:\Users\Usuario\Desktop\Practica Angular\14-back\tests\domain\use-cases\customers\update-city.use-case.test.js", "JavaScript", 0, 158, 0, 0, 30, 1, 189
"c:\Users\Usuario\Desktop\Practica Angular\14-back\tests\domain\use-cases\customers\update-city.use-case.test.ts", "TypeScript", 133, 0, 0, 0, 30, 43, 206
"c:\Users\Usuario\Desktop\Practica Angular\14-back\tests\domain\use-cases\customers\update-customer.use-case.test.js", "JavaScript", 0, 184, 0, 0, 39, 1, 224
"c:\Users\Usuario\Desktop\Practica Angular\14-back\tests\domain\use-cases\customers\update-customer.use-case.test.ts", "TypeScript", 188, 0, 0, 0, 39, 45, 272
"c:\Users\Usuario\Desktop\Practica Angular\14-back\tests\domain\use-cases\customers\update-neighborhood.use-case.test.js", "JavaScript", 0, 182, 0, 0, 43, 1, 226
"c:\Users\Usuario\Desktop\Practica Angular\14-back\tests\domain\use-cases\customers\update-neighborhood.use-case.test.ts", "TypeScript", 194, 0, 0, 0, 43, 50, 287
"c:\Users\Usuario\Desktop\Practica Angular\14-back\tests\domain\use-cases\product\create-product.use-case.test.js", "JavaScript", 0, 94, 0, 0, 24, 1, 119
"c:\Users\Usuario\Desktop\Practica Angular\14-back\tests\domain\use-cases\product\create-product.use-case.test.ts", "TypeScript", 114, 0, 0, 0, 25, 21, 160
"c:\Users\Usuario\Desktop\Practica Angular\14-back\tests\integration\auth\auth-routes.test.js", "JavaScript", 0, 169, 0, 0, 30, 1, 200
"c:\Users\Usuario\Desktop\Practica Angular\14-back\tests\integration\auth\auth-routes.test.ts", "TypeScript", 246, 0, 0, 0, 15, 38, 299
"c:\Users\Usuario\Desktop\Practica Angular\14-back\tests\integration\logger-abstraction.test.ts", "TypeScript", 29, 0, 0, 0, 2, 6, 37
"c:\Users\Usuario\Desktop\Practica Angular\14-back\tests\integration\mcp\mcp-routes.integration.test.ts", "TypeScript", 126, 0, 0, 0, 9, 30, 165
"c:\Users\Usuario\Desktop\Practica Angular\14-back\tests\integration\mcp\mcp.routes.test.new.ts", "TypeScript", 116, 0, 0, 0, 9, 27, 152
"c:\Users\Usuario\Desktop\Practica Angular\14-back\tests\integration\mcp\mcp.routes.test.ts", "TypeScript", 116, 0, 0, 0, 9, 27, 152
"c:\Users\Usuario\Desktop\Practica Angular\14-back\tests\integration\monitoring\monitoring-routes.integration.test.ts", "TypeScript", 174, 0, 0, 0, 21, 35, 230
"c:\Users\Usuario\Desktop\Practica Angular\14-back\tests\integration\monitoring\monitoring.integration.test.ts", "TypeScript", 107, 0, 0, 0, 0, 28, 135
"c:\Users\Usuario\Desktop\Practica Angular\14-back\tests\integration\order\select-payment-method.integration.test.ts", "TypeScript", 303, 0, 0, 0, 16, 28, 347
"c:\Users\Usuario\Desktop\Practica Angular\14-back\tests\integration\products\product-routes.test.js", "JavaScript", 0, 286, 0, 0, 58, 1, 345
"c:\Users\Usuario\Desktop\Practica Angular\14-back\tests\integration\products\product-routes.test.ts", "TypeScript", 240, 0, 0, 0, 25, 30, 295
"c:\Users\Usuario\Desktop\Practica Angular\14-back\tests\integration\telegram-notification.test.ts", "TypeScript", 75, 0, 0, 0, 5, 13, 93
"c:\Users\Usuario\Desktop\Practica Angular\14-back\tests\performance\CUSTOM_EXAMPLE_FIX.md", "Markdown", 0, 0, 71, 0, 0, 25, 96
"c:\Users\Usuario\Desktop\Practica Angular\14-back\tests\performance\README.md", "Markdown", 0, 0, 154, 0, 0, 68, 222
"c:\Users\Usuario\Desktop\Practica Angular\14-back\tests\performance\artillery-config.yml", "YAML", 0, 0, 0, 303, 0, 5, 308
"c:\Users\Usuario\Desktop\Practica Angular\14-back\tests\performance\artillery.test.ts", "TypeScript", 154, 0, 0, 0, 22, 42, 218
"c:\Users\Usuario\Desktop\Practica Angular\14-back\tests\performance\basic-load-fixed.test.ts", "TypeScript", 170, 0, 0, 0, 18, 38, 226
"c:\Users\Usuario\Desktop\Practica Angular\14-back\tests\performance\basic-load.test.ts", "TypeScript", 170, 0, 0, 0, 18, 38, 226
"c:\Users\Usuario\Desktop\Practica Angular\14-back\tests\performance\connectivity.test.ts", "TypeScript", 43, 0, 0, 0, 8, 19, 70
"c:\Users\Usuario\Desktop\Practica Angular\14-back\tests\performance\custom-example.test.ts", "TypeScript", 185, 0, 0, 0, 26, 67, 278
"c:\Users\Usuario\Desktop\Practica Angular\14-back\tests\performance\endpoint-specific.test.ts", "TypeScript", 174, 0, 0, 0, 23, 59, 256
"c:\Users\Usuario\Desktop\Practica Angular\14-back\tests\performance\performance-config.ts", "TypeScript", 64, 0, 0, 0, 15, 14, 93
"c:\Users\Usuario\Desktop\Practica Angular\14-back\tests\performance\performance-utils.ts", "TypeScript", 121, 0, 0, 0, 30, 28, 179
"c:\Users\Usuario\Desktop\Practica Angular\14-back\tests\performance\simple.test.ts", "TypeScript", 56, 0, 0, 0, 6, 18, 80
"c:\Users\Usuario\Desktop\Practica Angular\14-back\tests\presentation\auth\controller.auth.test.js", "JavaScript", 0, 130, 0, 0, 42, 1, 173
"c:\Users\Usuario\Desktop\Practica Angular\14-back\tests\presentation\auth\controller.auth.test.ts", "TypeScript", 159, 0, 0, 0, 57, 47, 263
"c:\Users\Usuario\Desktop\Practica Angular\14-back\tests\presentation\products\controller.product.test.js", "JavaScript", 0, 226, 0, 0, 61, 1, 288
"c:\Users\Usuario\Desktop\Practica Angular\14-back\tests\presentation\products\controller.product.test.ts", "TypeScript", 262, 0, 0, 0, 55, 51, 368
"c:\Users\Usuario\Desktop\Practica Angular\14-back\tests\smoke\health-check.smoke.test.ts", "TypeScript", 2661, 0, 0, 0, 202, 464, 3327
"c:\Users\Usuario\Desktop\Practica Angular\14-back\tests\test-logger.ts", "TypeScript", 28, 0, 0, 0, 5, 8, 41
"c:\Users\Usuario\Desktop\Practica Angular\14-back\tests\unit\data\mongodb\models\coupon\coupon.model.test.ts", "TypeScript", 360, 0, 0, 0, 5, 91, 456
"c:\Users\Usuario\Desktop\Practica Angular\14-back\tests\unit\domain\dtos\auth\forgot-password.dto.test.ts", "TypeScript", 91, 0, 0, 0, 1, 29, 121
"c:\Users\Usuario\Desktop\Practica Angular\14-back\tests\unit\domain\dtos\auth\login-user.dto.test.ts", "TypeScript", 115, 0, 0, 0, 1, 34, 150
"c:\Users\Usuario\Desktop\Practica Angular\14-back\tests\unit\domain\dtos\auth\register-user.dto.test.ts", "TypeScript", 191, 0, 0, 0, 1, 51, 243
"c:\Users\Usuario\Desktop\Practica Angular\14-back\tests\unit\domain\dtos\auth\reset-password.dto.test.ts", "TypeScript", 192, 0, 0, 0, 1, 52, 245
"c:\Users\Usuario\Desktop\Practica Angular\14-back\tests\unit\domain\dtos\coupon\create-coupon.dto.test.ts", "TypeScript", 320, 0, 0, 0, 9, 79, 408
"c:\Users\Usuario\Desktop\Practica Angular\14-back\tests\unit\domain\dtos\coupon\update-coupon.dto.test.ts", "TypeScript", 394, 0, 0, 0, 11, 118, 523
"c:\Users\Usuario\Desktop\Practica Angular\14-back\tests\unit\domain\dtos\mcp\mcp-call.dto.test.ts", "TypeScript", 95, 0, 0, 0, 1, 37, 133
"c:\Users\Usuario\Desktop\Practica Angular\14-back\tests\unit\domain\dtos\order\select-payment-method.dto.test.ts", "TypeScript", 80, 0, 0, 0, 1, 21, 102
"c:\Users\Usuario\Desktop\Practica Angular\14-back\tests\unit\domain\use-cases\coupon\create-coupon.use-case.test.ts", "TypeScript", 105, 0, 0, 0, 1, 28, 134
"c:\Users\Usuario\Desktop\Practica Angular\14-back\tests\unit\domain\use-cases\coupon\delete-coupon.use-case.test.ts", "TypeScript", 103, 0, 0, 0, 1, 30, 134
"c:\Users\Usuario\Desktop\Practica Angular\14-back\tests\unit\domain\use-cases\coupon\get-all-coupons.use-case.test.ts", "TypeScript", 119, 0, 0, 0, 1, 33, 153
"c:\Users\Usuario\Desktop\Practica Angular\14-back\tests\unit\domain\use-cases\coupon\get-coupon-by-id.use-case.test.ts", "TypeScript", 132, 0, 0, 0, 1, 37, 170
"c:\Users\Usuario\Desktop\Practica Angular\14-back\tests\unit\domain\use-cases\coupon\update-coupon.use-case.test.ts", "TypeScript", 188, 0, 0, 0, 5, 47, 240
"c:\Users\Usuario\Desktop\Practica Angular\14-back\tests\unit\domain\use-cases\mcp\call-tool.use-case.test.ts", "TypeScript", 74, 0, 0, 0, 10, 20, 104
"c:\Users\Usuario\Desktop\Practica Angular\14-back\tests\unit\domain\use-cases\mcp\list-tools.use-case.test.ts", "TypeScript", 55, 0, 0, 0, 9, 13, 77
"c:\Users\Usuario\Desktop\Practica Angular\14-back\tests\unit\domain\use-cases\order\select-payment-method.use-case.test.ts", "TypeScript", 181, 0, 0, 0, 1, 38, 220
"c:\Users\Usuario\Desktop\Practica Angular\14-back\tests\unit\domain\use-cases\product\tag\create-tag.use-case.test.ts", "TypeScript", 89, 0, 0, 0, 16, 24, 129
"c:\Users\Usuario\Desktop\Practica Angular\14-back\tests\unit\domain\use-cases\product\tag\delete-tag.use-case.test.ts", "TypeScript", 98, 0, 0, 0, 18, 26, 142
"c:\Users\Usuario\Desktop\Practica Angular\14-back\tests\unit\domain\use-cases\product\tag\get-all-tags.use-case.test.ts", "TypeScript", 106, 0, 0, 0, 24, 23, 153
"c:\Users\Usuario\Desktop\Practica Angular\14-back\tests\unit\domain\use-cases\product\tag\get-tag-by-id.use-case.test.ts", "TypeScript", 135, 0, 0, 0, 27, 35, 197
"c:\Users\Usuario\Desktop\Practica Angular\14-back\tests\unit\domain\use-cases\product\tag\update-tag.use-case.test.ts", "TypeScript", 143, 0, 0, 0, 31, 37, 211
"c:\Users\Usuario\Desktop\Practica Angular\14-back\tests\unit\infrastructure\adapters\cloudinary.adapter.test.ts", "TypeScript", 179, 0, 0, 0, 7, 43, 229
"c:\Users\Usuario\Desktop\Practica Angular\14-back\tests\unit\infrastructure\adapters\mercado-pago-payment.adapter.test.ts", "TypeScript", 72, 0, 0, 0, 1, 14, 87
"c:\Users\Usuario\Desktop\Practica Angular\14-back\tests\unit\infrastructure\adapters\nodemailer.adapter.test.ts", "TypeScript", 229, 0, 0, 0, 14, 50, 293
"c:\Users\Usuario\Desktop\Practica Angular\14-back\tests\unit\infrastructure\adapters\telegram-notification.adapter.test.ts", "TypeScript", 217, 0, 0, 0, 4, 42, 263
"c:\Users\Usuario\Desktop\Practica Angular\14-back\tests\unit\infrastructure\repositories\mcp\mcp.repository.impl.test.ts", "TypeScript", 52, 0, 0, 0, 11, 14, 77
"c:\Users\Usuario\Desktop\Practica Angular\14-back\tests\unit\presentation\controllers\mcp.controller.test.ts", "TypeScript", 79, 0, 0, 0, 17, 21, 117
"c:\Users\Usuario\Desktop\Practica Angular\14-back\tests\utils\global-setup.js", "JavaScript", 0, 32, 0, 0, 4, 1, 37
"c:\Users\Usuario\Desktop\Practica Angular\14-back\tests\utils\global-setup.ts", "TypeScript", 18, 0, 0, 0, 4, 5, 27
"c:\Users\Usuario\Desktop\Practica Angular\14-back\tests\utils\global-teardown.js", "JavaScript", 0, 20, 0, 0, 2, 1, 23
"c:\Users\Usuario\Desktop\Practica Angular\14-back\tests\utils\global-teardown.ts", "TypeScript", 6, 0, 0, 0, 2, 1, 9
"c:\Users\Usuario\Desktop\Practica Angular\14-back\tests\utils\setup.js", "JavaScript", 0, 41, 0, 0, 5, 1, 47
"c:\Users\Usuario\Desktop\Practica Angular\14-back\tests\utils\setup.ts", "TypeScript", 21, 0, 0, 0, 7, 9, 37
"c:\Users\Usuario\Desktop\Practica Angular\14-back\tests\utils\test-utils.js", "JavaScript", 0, 38, 0, 0, 4, 1, 43
"c:\Users\Usuario\Desktop\Practica Angular\14-back\tests\utils\test-utils.ts", "TypeScript", 35, 0, 0, 0, 4, 4, 43
"Total", "-", -3971, 6056, 225, 303, 2028, 356, 4997